episode,score,total_score,eval_score,d2qn_score,d2qn_total_score,d2qn_eval_score
1,12,12,114.64,14,14,114.64
2,11,23,114.64,12,26,114.64
3,12,35,114.64,22,48,114.65
4,9,44,114.65,9,57,114.65
5,11,55,114.65,14,71,114.65
6,16,71,114.65,18,89,114.66
7,8,79,114.65,9,98,114.66
8,16,95,114.66,10,108,114.66
9,22,117,114.66,12,120,114.66
10,27,144,114.67,12,132,114.66
11,11,155,114.67,10,142,114.67
12,14,169,114.67,17,159,114.67
13,14,183,114.67,9,168,114.67
14,13,196,114.68,12,180,114.67
15,17,213,114.68,29,209,114.68
16,16,229,114.68,21,230,114.68
17,10,239,114.69,14,244,114.69
18,11,250,114.69,16,260,114.69
19,12,262,114.69,13,273,114.69
20,10,272,114.69,10,283,114.7
21,9,281,114.69,11,294,114.7
22,15,296,114.7,10,304,114.7
23,11,307,114.7,13,317,114.7
24,8,315,114.7,14,331,114.71
25,14,329,114.7,17,348,114.71
26,11,340,114.71,10,358,114.71
27,12,352,114.71,10,368,114.71
28,15,367,114.71,19,387,114.72
29,20,387,114.72,11,398,114.72
30,46,433,114.73,11,409,114.72
31,10,443,114.73,10,419,114.72
32,15,458,114.73,16,435,114.73
33,12,470,114.73,20,455,114.73
34,10,480,114.74,28,483,114.74
35,9,489,114.74,10,493,114.74
36,8,497,114.74,10,503,114.74
37,17,514,114.74,10,513,114.74
38,10,524,114.75,11,524,114.75
39,20,544,114.75,21,545,114.75
40,14,558,114.75,12,557,114.75
41,19,577,114.76,12,569,114.75
42,14,591,114.76,16,585,114.76
43,9,600,114.76,9,594,114.76
44,10,610,114.76,10,604,114.76
45,10,620,114.77,10,614,114.76
46,12,632,114.77,13,627,114.77
47,10,642,114.77,10,637,114.77
48,10,652,114.77,35,672,114.78
49,11,663,114.77,10,682,114.78
50,12,675,114.78,11,693,114.78
51,12,687,114.78,9,702,114.78
52,11,698,114.78,16,718,114.79
53,9,707,114.78,10,728,114.79
54,15,722,114.79,17,745,114.79
55,10,732,114.79,22,767,114.8
56,10,742,114.79,11,778,114.8
57,14,756,114.79,14,792,114.8
58,14,770,114.8,13,805,114.8
59,10,780,114.8,19,824,114.81
60,9,789,114.8,14,838,114.81
61,24,813,114.81,14,852,114.81
62,15,828,114.81,17,869,114.82
63,15,843,114.81,14,883,114.82
64,11,854,114.81,9,892,114.82
65,14,868,114.82,11,903,114.82
66,11,879,114.82,9,912,114.83
67,18,897,114.82,10,922,114.83
68,15,912,114.83,15,937,114.83
69,21,933,114.83,9,946,114.83
70,29,962,114.84,15,961,114.84
71,14,976,114.84,11,972,114.84
72,9,985,114.84,11,983,114.84
73,11,996,114.84,10,993,114.84
74,12,1008,114.85,9,1002,114.84
75,10,1018,114.85,8,1010,114.85
76,26,1044,114.85,12,1022,114.85
77,11,1055,114.86,12,1034,114.85
78,32,1087,114.86,21,1055,114.86
79,9,1096,114.86,10,1065,114.86
80,12,1108,114.87,25,1090,114.86
81,19,1127,114.87,11,1101,114.86
82,10,1137,114.87,12,1113,114.87
83,15,1152,114.88,14,1127,114.87
84,10,1162,114.88,15,1142,114.87
85,25,1187,114.88,14,1156,114.88
86,37,1224,114.89,23,1179,114.88
87,10,1234,114.89,11,1190,114.88
88,12,1246,114.89,10,1200,114.89
89,10,1256,114.9,10,1210,114.89
90,21,1277,114.9,11,1221,114.89
91,14,1291,114.9,8,1229,114.89
92,12,1303,114.91,15,1244,114.89
93,10,1313,114.91,13,1257,114.9
94,13,1326,114.91,11,1268,114.9
95,10,1336,114.91,10,1278,114.9
96,10,1346,114.92,14,1292,114.9
97,10,1356,114.92,13,1305,114.91
98,12,1368,114.92,9,1314,114.91
99,17,1385,114.92,16,1330,114.91
100,13,1398,114.93,10,1340,114.91
101,19,1417,114.93,9,1349,114.92
102,18,1435,114.93,19,1368,114.92
103,9,1444,114.94,12,1380,114.92
104,11,1455,114.94,9,1389,114.92
105,12,1467,114.94,11,1400,114.93
106,13,1480,114.94,13,1413,114.93
107,12,1492,114.95,19,1432,114.93
108,12,1504,114.95,11,1443,114.94
109,15,1519,114.95,13,1456,114.94
110,10,1529,114.95,11,1467,114.94
111,10,1539,114.96,11,1478,114.94
112,17,1556,114.96,10,1488,114.94
113,16,1572,114.96,12,1500,114.95
114,12,1584,114.96,13,1513,114.95
115,11,1595,114.97,11,1524,114.95
116,11,1606,114.97,10,1534,114.95
117,13,1619,114.97,11,1545,114.96
118,13,1632,114.97,11,1556,114.96
119,11,1643,114.98,9,1565,114.96
120,10,1653,114.98,12,1577,114.96
121,15,1668,114.98,11,1588,114.97
122,11,1679,114.98,10,1598,114.97
123,11,1690,114.99,10,1608,114.97
124,15,1705,114.99,13,1621,114.97
125,12,1717,114.99,10,1631,114.97
126,8,1725,114.99,8,1639,114.98
127,13,1738,115,12,1651,114.98
128,12,1750,115,10,1661,114.98
129,9,1759,115,8,1669,114.98
130,10,1769,115,10,1679,114.98
131,16,1785,115.01,16,1695,114.99
132,12,1797,115.01,11,1706,114.99
133,10,1807,115.01,10,1716,114.99
134,12,1819,115.01,12,1728,114.99
135,13,1832,115.02,13,1741,115
136,11,1843,115.02,12,1753,115
137,10,1853,115.02,13,1766,115
138,10,1863,115.02,9,1775,115
139,10,1873,115.02,11,1786,115.01
140,8,1881,115.03,12,1798,115.01
141,13,1894,115.03,13,1811,115.01
142,13,1907,115.03,18,1829,115.02
143,12,1919,115.03,10,1839,115.02
144,11,1930,115.04,14,1853,115.02
145,9,1939,115.04,15,1868,115.02
146,11,1950,115.04,9,1877,115.03
147,13,1963,115.04,10,1887,115.03
148,15,1978,115.05,11,1898,115.03
149,9,1987,115.05,11,1909,115.03
150,10,1997,115.05,11,1920,115.03
151,9,2006,115.05,14,1934,115.04
152,13,2019,115.05,14,1948,115.04
153,12,2031,115.06,18,1966,115.04
154,23,2054,115.06,14,1980,115.05
155,12,2066,115.06,10,1990,115.05
156,10,2076,115.07,10,2000,115.05
157,23,2099,115.07,8,2008,115.05
158,16,2115,115.07,8,2016,115.05
159,13,2128,115.08,10,2026,115.06
160,9,2137,115.08,10,2036,115.06
161,19,2156,115.08,10,2046,115.06
162,16,2172,115.09,14,2060,115.06
163,14,2186,115.09,21,2081,115.07
164,11,2197,115.09,15,2096,115.07
165,12,2209,115.09,17,2113,115.07
166,13,2222,115.1,11,2124,115.08
167,15,2237,115.1,13,2137,115.08
168,13,2250,115.1,12,2149,115.08
169,13,2263,115.1,10,2159,115.08
170,20,2283,115.11,15,2174,115.09
171,12,2295,115.11,28,2202,115.09
172,19,2314,115.12,10,2212,115.09
173,13,2327,115.12,13,2225,115.1
174,19,2346,115.12,13,2238,115.1
175,16,2362,115.13,12,2250,115.1
176,14,2376,115.13,11,2261,115.1
177,10,2386,115.13,14,2275,115.11
178,16,2402,115.13,11,2286,115.11
179,13,2415,115.14,14,2300,115.11
180,20,2435,115.14,10,2310,115.11
181,20,2455,115.14,11,2321,115.12
182,16,2471,115.15,15,2336,115.12
183,14,2485,115.15,11,2347,115.12
184,13,2498,115.15,19,2366,115.13
185,17,2515,115.16,13,2379,115.13
186,14,2529,115.16,15,2394,115.13
187,22,2551,115.16,16,2410,115.14
188,15,2566,115.17,12,2422,115.14
189,17,2583,115.17,19,2441,115.14
190,14,2597,115.17,25,2466,115.15
191,15,2612,115.18,9,2475,115.15
192,18,2630,115.18,10,2485,115.15
193,18,2648,115.18,8,2493,115.15
194,15,2663,115.19,10,2503,115.15
195,18,2681,115.19,11,2514,115.16
196,16,2697,115.19,19,2533,115.16
197,25,2722,115.2,14,2547,115.16
198,20,2742,115.2,16,2563,115.17
199,18,2760,115.21,17,2580,115.17
200,19,2779,115.21,14,2594,115.17
201,19,2798,115.22,14,2608,115.18
202,20,2818,115.22,14,2622,115.18
203,28,2846,115.23,10,2632,115.18
204,50,2896,115.24,14,2646,115.18
205,25,2921,115.24,14,2660,115.19
206,44,2965,115.25,21,2681,115.19
207,25,2990,115.26,14,2695,115.19
208,30,3020,115.26,22,2717,115.2
209,19,3039,115.27,64,2781,115.21
210,17,3056,115.27,12,2793,115.21
211,9,3065,115.27,10,2803,115.22
212,14,3079,115.27,10,2813,115.22
213,26,3105,115.28,13,2826,115.22
214,18,3123,115.28,15,2841,115.22
215,10,3133,115.28,11,2852,115.23
216,21,3154,115.29,11,2863,115.23
217,12,3166,115.29,12,2875,115.23
218,9,3175,115.29,13,2888,115.23
219,13,3188,115.3,28,2916,115.24
220,10,3198,115.3,11,2927,115.24
221,13,3211,115.3,15,2942,115.25
222,12,3223,115.3,33,2975,115.25
223,9,3232,115.31,19,2994,115.26
224,10,3242,115.31,10,3004,115.26
225,11,3253,115.31,12,3016,115.26
226,10,3263,115.31,11,3027,115.26
227,10,3273,115.31,13,3040,115.27
228,9,3282,115.32,17,3057,115.27
229,16,3298,115.32,11,3068,115.27
230,10,3308,115.32,18,3086,115.28
231,18,3326,115.32,25,3111,115.28
232,9,3335,115.33,14,3125,115.28
233,8,3343,115.33,10,3135,115.29
234,9,3352,115.33,19,3154,115.29
235,23,3375,115.34,9,3163,115.29
236,11,3386,115.34,21,3184,115.3
237,12,3398,115.34,9,3193,115.3
238,10,3408,115.34,10,3203,115.3
239,10,3418,115.34,12,3215,115.3
240,12,3430,115.35,13,3228,115.3
241,10,3440,115.35,9,3237,115.31
242,8,3448,115.35,9,3246,115.31
243,13,3461,115.35,9,3255,115.31
244,13,3474,115.36,11,3266,115.31
245,9,3483,115.36,13,3279,115.32
246,11,3494,115.36,10,3289,115.32
247,10,3504,115.36,14,3303,115.32
248,11,3515,115.36,13,3316,115.32
249,24,3539,115.37,13,3329,115.33
250,15,3554,115.37,12,3341,115.33
251,11,3565,115.37,10,3351,115.33
252,13,3578,115.38,13,3364,115.33
253,11,3589,115.38,10,3374,115.33
254,11,3600,115.38,9,3383,115.34
255,12,3612,115.38,16,3399,115.34
256,12,3624,115.39,18,3417,115.34
257,9,3633,115.39,10,3427,115.35
258,10,3643,115.39,10,3437,115.35
259,9,3652,115.39,9,3446,115.35
260,9,3661,115.39,12,3458,115.35
261,12,3673,115.4,13,3471,115.35
262,12,3685,115.4,10,3481,115.36
263,11,3696,115.4,10,3491,115.36
264,9,3705,115.4,12,3503,115.36
265,10,3715,115.41,16,3519,115.36
266,9,3724,115.41,10,3529,115.37
267,10,3734,115.41,11,3540,115.37
268,11,3745,115.41,15,3555,115.37
269,14,3759,115.41,8,3563,115.37
270,17,3776,115.42,10,3573,115.38
271,20,3796,115.42,10,3583,115.38
272,26,3822,115.43,10,3593,115.38
273,24,3846,115.43,16,3609,115.38
274,26,3872,115.44,10,3619,115.39
275,21,3893,115.44,14,3633,115.39
276,22,3915,115.45,12,3645,115.39
277,20,3935,115.45,10,3655,115.39
278,21,3956,115.46,17,3672,115.4
279,28,3984,115.46,10,3682,115.4
280,47,4031,115.47,10,3692,115.4
281,60,4091,115.48,12,3704,115.4
282,23,4114,115.49,10,3714,115.41
283,23,4137,115.49,9,3723,115.41
284,27,4164,115.5,11,3734,115.41
285,21,4185,115.5,11,3745,115.41
286,20,4205,115.51,10,3755,115.41
287,25,4230,115.51,18,3773,115.42
288,18,4248,115.52,9,3782,115.42
289,21,4269,115.52,8,3790,115.42
290,17,4286,115.52,10,3800,115.42
291,15,4301,115.53,10,3810,115.43
292,18,4319,115.53,9,3819,115.43
293,15,4334,115.53,10,3829,115.43
294,21,4355,115.54,10,3839,115.43
295,20,4375,115.54,14,3853,115.43
296,13,4388,115.54,10,3863,115.44
297,13,4401,115.55,11,3874,115.44
298,20,4421,115.55,10,3884,115.44
299,9,4430,115.55,9,3893,115.44
300,12,4442,115.56,12,3905,115.44
301,13,4455,115.56,15,3920,115.45
302,9,4464,115.56,13,3933,115.45
303,15,4479,115.56,8,3941,115.45
304,10,4489,115.57,14,3955,115.46
305,11,4500,115.57,9,3964,115.46
306,9,4509,115.57,9,3973,115.46
307,11,4520,115.57,13,3986,115.46
308,11,4531,115.57,10,3996,115.46
309,10,4541,115.58,12,4008,115.47
310,16,4557,115.58,12,4020,115.47
311,13,4570,115.58,11,4031,115.47
312,11,4581,115.58,11,4042,115.47
313,11,4592,115.59,11,4053,115.48
314,10,4602,115.59,11,4064,115.48
315,8,4610,115.59,11,4075,115.48
316,9,4619,115.59,10,4085,115.48
317,15,4634,115.6,10,4095,115.48
318,10,4644,115.6,10,4105,115.49
319,11,4655,115.6,13,4118,115.49
320,21,4676,115.6,12,4130,115.49
321,12,4688,115.61,10,4140,115.49
322,8,4696,115.61,14,4154,115.5
323,10,4706,115.61,10,4164,115.5
324,16,4722,115.61,11,4175,115.5
325,9,4731,115.62,13,4188,115.5
326,11,4742,115.62,11,4199,115.51
327,11,4753,115.62,12,4211,115.51
328,9,4762,115.62,13,4224,115.51
329,12,4774,115.62,11,4235,115.51
330,9,4783,115.63,11,4246,115.52
331,11,4794,115.63,12,4258,115.52
332,14,4808,115.63,10,4268,115.52
333,12,4820,115.63,9,4277,115.52
334,9,4829,115.64,12,4289,115.52
335,9,4838,115.64,11,4300,115.53
336,13,4851,115.64,17,4317,115.53
337,14,4865,115.64,10,4327,115.53
338,15,4880,115.65,11,4338,115.53
339,10,4890,115.65,13,4351,115.54
340,13,4903,115.65,15,4366,115.54
341,14,4917,115.65,13,4379,115.54
342,13,4930,115.66,10,4389,115.54
343,22,4952,115.66,13,4402,115.55
344,13,4965,115.66,10,4412,115.55
345,14,4979,115.67,15,4427,115.55
346,18,4997,115.67,13,4440,115.56
347,19,5016,115.67,16,4456,115.56
348,18,5034,115.68,12,4468,115.56
349,14,5048,115.68,18,4486,115.56
350,22,5070,115.69,25,4511,115.57
351,28,5098,115.69,21,4532,115.57
352,63,5161,115.7,39,4571,115.58
353,27,5188,115.71,19,4590,115.59
354,21,5209,115.71,18,4608,115.59
355,24,5233,115.72,16,4624,115.59
356,40,5273,115.73,13,4637,115.6
357,185,5458,115.77,11,4648,115.6
358,23,5481,115.77,13,4661,115.6
359,27,5508,115.78,11,4672,115.6
360,67,5575,115.79,12,4684,115.61
361,22,5597,115.79,15,4699,115.61
362,21,5618,115.8,14,4713,115.61
363,16,5634,115.8,16,4729,115.62
364,20,5654,115.81,12,4741,115.62
365,10,5664,115.81,12,4753,115.62
366,22,5686,115.81,13,4766,115.62
367,23,5709,115.82,13,4779,115.63
368,33,5742,115.82,17,4796,115.63
369,13,5755,115.83,9,4805,115.63
370,19,5774,115.83,12,4817,115.63
371,15,5789,115.83,10,4827,115.64
372,18,5807,115.84,12,4839,115.64
373,23,5830,115.84,10,4849,115.64
374,13,5843,115.85,14,4863,115.64
375,15,5858,115.85,14,4877,115.65
376,24,5882,115.85,9,4886,115.65
377,16,5898,115.86,11,4897,115.65
378,16,5914,115.86,10,4907,115.65
379,21,5935,115.86,8,4915,115.65
380,25,5960,115.87,9,4924,115.66
381,15,5975,115.87,13,4937,115.66
382,18,5993,115.88,10,4947,115.66
383,18,6011,115.88,13,4960,115.66
384,25,6036,115.89,9,4969,115.66
385,26,6062,115.89,8,4977,115.67
386,36,6098,115.9,10,4987,115.67
387,53,6151,115.91,12,4999,115.67
388,35,6186,115.92,10,5009,115.67
389,105,6291,115.94,11,5020,115.68
390,29,6320,115.94,9,5029,115.68
391,40,6360,115.95,10,5039,115.68
392,49,6409,115.96,10,5049,115.68
393,42,6451,115.97,10,5059,115.68
394,76,6527,115.99,11,5070,115.69
395,53,6580,116,10,5080,115.69
396,49,6629,116.01,9,5089,115.69
397,45,6674,116.02,11,5100,115.69
398,41,6715,116.03,10,5110,115.69
399,37,6752,116.03,9,5119,115.7
400,91,6843,116.05,10,5129,115.7
401,36,6879,116.06,10,5139,115.7
402,47,6926,116.07,14,5153,115.7
403,32,6958,116.08,12,5165,115.71
404,42,7000,116.08,9,5174,115.71
405,24,7024,116.09,10,5184,115.71
406,25,7049,116.1,10,5194,115.71
407,30,7079,116.1,10,5204,115.71
408,21,7100,116.11,9,5213,115.72
409,30,7130,116.11,9,5222,115.72
410,37,7167,116.12,9,5231,115.72
411,34,7201,116.13,11,5242,115.72
412,85,7286,116.14,11,5253,115.72
413,27,7313,116.15,9,5262,115.73
414,26,7339,116.16,10,5272,115.73
415,66,7405,116.17,11,5283,115.73
416,66,7471,116.18,15,5298,115.73
417,58,7529,116.19,10,5308,115.73
418,79,7608,116.21,9,5317,115.74
419,63,7671,116.22,9,5326,115.74
420,65,7736,116.24,12,5338,115.74
421,38,7774,116.25,13,5351,115.74
422,113,7887,116.27,11,5362,115.75
423,43,7930,116.28,10,5372,115.75
424,28,7958,116.28,9,5381,115.75
425,42,8000,116.29,13,5394,115.75
426,26,8026,116.3,11,5405,115.76
427,43,8069,116.31,16,5421,115.76
428,35,8104,116.31,11,5432,115.76
429,54,8158,116.32,14,5446,115.76
430,44,8202,116.33,13,5459,115.77
431,57,8259,116.35,11,5470,115.77
432,40,8299,116.35,13,5483,115.77
433,37,8336,116.36,10,5493,115.77
434,41,8377,116.37,13,5506,115.78
435,41,8418,116.38,14,5520,115.78
436,27,8445,116.38,10,5530,115.78
437,67,8512,116.4,10,5540,115.78
438,41,8553,116.41,12,5552,115.79
439,34,8587,116.41,18,5570,115.79
440,39,8626,116.42,9,5579,115.79
441,60,8686,116.43,13,5592,115.79
442,37,8723,116.44,11,5603,115.8
443,41,8764,116.45,12,5615,115.8
444,27,8791,116.46,11,5626,115.8
445,32,8823,116.46,9,5635,115.8
446,35,8858,116.47,14,5649,115.81
447,44,8902,116.48,10,5659,115.81
448,34,8936,116.49,10,5669,115.81
449,34,8970,116.49,13,5682,115.81
450,33,9003,116.5,13,5695,115.82
451,38,9041,116.51,13,5708,115.82
452,103,9144,116.53,16,5724,115.82
453,36,9180,116.54,16,5740,115.82
454,46,9226,116.55,14,5754,115.83
455,35,9261,116.55,11,5765,115.83
456,46,9307,116.56,16,5781,115.83
457,47,9354,116.57,15,5796,115.84
458,59,9413,116.58,15,5811,115.84
459,51,9464,116.59,20,5831,115.84
460,48,9512,116.6,19,5850,115.85
461,42,9554,116.61,16,5866,115.85
462,85,9639,116.63,13,5879,115.85
463,45,9684,116.64,19,5898,115.86
464,47,9731,116.65,22,5920,115.86
465,78,9809,116.67,27,5947,115.87
466,74,9883,116.68,27,5974,115.87
467,54,9937,116.69,30,6004,115.88
468,82,10019,116.71,63,6067,115.89
469,73,10092,116.72,20,6087,115.9
470,71,10163,116.74,20,6107,115.9
471,50,10213,116.75,16,6123,115.9
472,64,10277,116.76,29,6152,115.91
473,50,10327,116.77,23,6175,115.91
474,45,10372,116.78,22,6197,115.92
475,53,10425,116.79,28,6225,115.92
476,58,10483,116.81,15,6240,115.93
477,29,10512,116.81,17,6257,115.93
478,31,10543,116.82,16,6273,115.93
479,34,10577,116.82,13,6286,115.94
480,27,10604,116.83,18,6304,115.94
481,28,10632,116.84,19,6323,115.94
482,30,10662,116.84,16,6339,115.95
483,35,10697,116.85,14,6353,115.95
484,38,10735,116.86,17,6370,115.95
485,29,10764,116.86,15,6385,115.96
486,34,10798,116.87,26,6411,115.96
487,36,10834,116.88,23,6434,115.97
488,27,10861,116.88,24,6458,115.97
489,32,10893,116.89,23,6481,115.98
490,27,10920,116.9,19,6500,115.98
491,31,10951,116.9,25,6525,115.99
492,34,10985,116.91,23,6548,115.99
493,25,11010,116.91,23,6571,116
494,44,11054,116.92,22,6593,116
495,42,11096,116.93,16,6609,116
496,64,11160,116.95,12,6621,116.01
497,53,11213,116.96,21,6642,116.01
498,86,11299,116.97,26,6668,116.02
499,105,11404,117,28,6696,116.02
500,38,11442,117,25,6721,116.03
501,42,11484,117.01,18,6739,116.03
502,55,11539,117.02,25,6764,116.04
503,53,11592,117.03,26,6790,116.04
504,34,11626,117.04,36,6826,116.05
505,52,11678,117.05,73,6899,116.06
506,32,11710,117.06,31,6930,116.07
507,55,11765,117.07,72,7002,116.09
508,52,11817,117.08,61,7063,116.1
509,48,11865,117.09,73,7136,116.11
510,46,11911,117.1,39,7175,116.12
511,34,11945,117.11,74,7249,116.14
512,46,11991,117.12,136,7385,116.16
513,31,12022,117.12,32,7417,116.17
514,39,12061,117.13,24,7441,116.18
515,21,12082,117.14,33,7474,116.18
516,24,12106,117.14,37,7511,116.19
517,41,12147,117.15,26,7537,116.2
518,42,12189,117.16,32,7569,116.2
519,26,12215,117.16,30,7599,116.21
520,40,12255,117.17,24,7623,116.21
521,26,12281,117.18,28,7651,116.22
522,28,12309,117.18,41,7692,116.23
523,37,12346,117.19,63,7755,116.24
524,24,12370,117.2,51,7806,116.25
525,97,12467,117.22,53,7859,116.26
526,158,12625,117.25,27,7886,116.27
527,184,12809,117.29,19,7905,116.27
528,179,12988,117.32,23,7928,116.28
529,176,13164,117.36,45,7973,116.29
530,177,13341,117.4,69,8042,116.3
531,183,13524,117.43,226,8268,116.35
532,30,13554,117.44,114,8382,116.37
533,25,13579,117.45,63,8445,116.38
534,35,13614,117.45,62,8507,116.4
535,27,13641,117.46,77,8584,116.41
536,148,13789,117.49,40,8624,116.42
537,108,13897,117.51,51,8675,116.43
538,151,14048,117.54,88,8763,116.45
539,88,14136,117.56,122,8885,116.47
540,166,14302,117.6,76,8961,116.49
541,452,14754,117.69,66,9027,116.5
542,232,14986,117.74,56,9083,116.52
543,204,15190,117.78,84,9167,116.53
544,257,15447,117.83,93,9260,116.55
545,250,15697,117.88,37,9297,116.56
546,211,15908,117.93,73,9370,116.58
547,197,16105,117.97,67,9437,116.59
548,202,16307,118.01,66,9503,116.6
549,180,16487,118.05,63,9566,116.62
550,426,16913,118.14,73,9639,116.63
551,500,17413,118.24,63,9702,116.64
552,500,17913,118.34,27,9729,116.65
553,500,18413,118.45,40,9769,116.66
554,236,18649,118.49,40,9809,116.67
555,81,18730,118.51,35,9844,116.67
556,48,18778,118.52,28,9872,116.68
557,14,18792,118.52,54,9926,116.69
558,12,18804,118.53,69,9995,116.7
559,9,18813,118.53,39,10034,116.71
560,9,18822,118.53,67,10101,116.73
561,13,18835,118.53,207,10308,116.77
562,14,18849,118.54,66,10374,116.78
563,9,18858,118.54,49,10423,116.79
564,9,18867,118.54,61,10484,116.81
565,9,18876,118.54,83,10567,116.82
566,11,18887,118.54,36,10603,116.83
567,10,18897,118.55,32,10635,116.84
568,9,18906,118.55,50,10685,116.85
569,11,18917,118.55,48,10733,116.86
570,13,18930,118.55,43,10776,116.87
571,160,19090,118.59,54,10830,116.88
572,107,19197,118.61,65,10895,116.89
573,117,19314,118.63,37,10932,116.9
574,101,19415,118.65,50,10982,116.91
575,103,19518,118.67,34,11016,116.92
576,110,19628,118.7,50,11066,116.93
577,103,19731,118.72,53,11119,116.94
578,39,19770,118.73,36,11155,116.94
579,104,19874,118.75,116,11271,116.97
580,97,19971,118.77,52,11323,116.98
581,101,20072,118.79,82,11405,117
582,111,20183,118.81,122,11527,117.02
583,117,20300,118.84,127,11654,117.05
584,114,20414,118.86,77,11731,117.06
585,110,20524,118.88,58,11789,117.08
586,29,20553,118.89,58,11847,117.09
587,105,20658,118.91,43,11890,117.1
588,111,20769,118.93,57,11947,117.11
589,109,20878,118.96,68,12015,117.12
590,124,21002,118.98,126,12141,117.15
591,108,21110,119,149,12290,117.18
592,161,21271,119.04,87,12377,117.2
593,142,21413,119.07,117,12494,117.22
594,133,21546,119.09,139,12633,117.25
595,126,21672,119.12,74,12707,117.27
596,135,21807,119.15,182,12889,117.3
597,115,21922,119.17,163,13052,117.34
598,107,22029,119.19,468,13520,117.43
599,134,22163,119.22,61,13581,117.45
600,151,22314,119.25,119,13700,117.47
601,146,22460,119.28,166,13866,117.51
602,345,22805,119.35,142,14008,117.53
603,500,23305,119.46,107,14115,117.56
604,194,23499,119.5,88,14203,117.58
605,265,23764,119.55,114,14317,117.6
606,139,23903,119.58,164,14481,117.63
607,138,24041,119.61,197,14678,117.67
608,136,24177,119.64,171,14849,117.71
609,122,24299,119.66,208,15057,117.75
610,70,24369,119.68,176,15233,117.79
611,49,24418,119.69,217,15450,117.83
612,40,24458,119.7,159,15609,117.87
613,23,24481,119.7,193,15802,117.91
614,21,24502,119.71,196,15998,117.95
615,27,24529,119.71,181,16179,117.98
616,30,24559,119.72,153,16332,118.02
617,44,24603,119.73,112,16444,118.04
618,23,24626,119.73,125,16569,118.06
619,22,24648,119.74,134,16703,118.09
620,29,24677,119.74,135,16838,118.12
621,27,24704,119.75,147,16985,118.15
622,35,24739,119.75,202,17187,118.19
623,93,24832,119.77,195,17382,118.23
624,91,24923,119.79,168,17550,118.27
625,128,25051,119.82,142,17692,118.3
626,145,25196,119.85,127,17819,118.32
627,260,25456,119.9,148,17967,118.35
628,159,25615,119.94,156,18123,118.39
629,303,25918,120,182,18305,118.42
630,144,26062,120.03,171,18476,118.46
631,67,26129,120.04,150,18626,118.49
632,95,26224,120.06,315,18941,118.56
633,111,26335,120.09,161,19102,118.59
634,85,26420,120.1,460,19562,118.68
635,70,26490,120.12,287,19849,118.74
636,44,26534,120.13,182,20031,118.78
637,42,26576,120.13,212,20243,118.82
638,58,26634,120.15,158,20401,118.86
639,114,26748,120.17,134,20535,118.89
640,124,26872,120.2,147,20682,118.92
641,91,26963,120.21,121,20803,118.94
642,175,27138,120.25,116,20919,118.96
643,170,27308,120.29,141,21060,118.99
644,44,27352,120.3,120,21180,119.02
645,52,27404,120.31,193,21373,119.06
646,65,27469,120.32,175,21548,119.09
647,40,27509,120.33,195,21743,119.14
648,76,27585,120.34,251,21994,119.19
649,33,27618,120.35,135,22129,119.21
650,55,27673,120.36,132,22261,119.24
651,59,27732,120.37,134,22395,119.27
652,118,27850,120.4,119,22514,119.29
653,88,27938,120.42,25,22539,119.3
654,141,28079,120.45,131,22670,119.33
655,204,28283,120.49,132,22802,119.35
656,131,28414,120.52,127,22929,119.38
657,123,28537,120.54,125,23054,119.41
658,86,28623,120.56,132,23186,119.43
659,135,28758,120.59,123,23309,119.46
660,139,28897,120.62,140,23449,119.49
661,160,29057,120.65,160,23609,119.52
662,113,29170,120.67,154,23763,119.55
663,123,29293,120.7,131,23894,119.58
664,115,29408,120.72,104,23998,119.6
665,101,29509,120.74,187,24185,119.64
666,99,29608,120.76,181,24366,119.68
667,75,29683,120.78,157,24523,119.71
668,98,29781,120.8,139,24662,119.74
669,95,29876,120.82,174,24836,119.77
670,84,29960,120.83,154,24990,119.81
671,36,29996,120.84,127,25117,119.83
672,92,30088,120.86,131,25248,119.86
673,33,30121,120.87,157,25405,119.89
674,22,30143,120.87,148,25553,119.92
675,32,30175,120.88,108,25661,119.95
676,33,30208,120.89,110,25771,119.97
677,29,30237,120.89,111,25882,119.99
678,28,30265,120.9,116,25998,120.02
679,26,30291,120.9,114,26112,120.04
680,32,30323,120.91,122,26234,120.06
681,30,30353,120.92,116,26350,120.09
682,32,30385,120.92,120,26470,120.11
683,31,30416,120.93,110,26580,120.14
684,27,30443,120.93,146,26726,120.17
685,28,30471,120.94,139,26865,120.19
686,17,30488,120.94,115,26980,120.22
687,28,30516,120.95,128,27108,120.24
688,18,30534,120.95,125,27233,120.27
689,21,30555,120.96,127,27360,120.3
690,16,30571,120.96,120,27480,120.32
691,21,30592,120.97,106,27586,120.34
692,25,30617,120.97,109,27695,120.37
693,29,30646,120.98,114,27809,120.39
694,26,30672,120.98,151,27960,120.42
695,32,30704,120.99,170,28130,120.46
696,30,30734,121,166,28296,120.49
697,30,30764,121,150,28446,120.52
698,26,30790,121.01,182,28628,120.56
699,28,30818,121.01,156,28784,120.59
700,32,30850,121.02,123,28907,120.62
701,91,30941,121.04,123,29030,120.64
702,80,31021,121.05,31,29061,120.65
703,97,31118,121.07,118,29179,120.67
704,85,31203,121.09,126,29305,120.7
705,93,31296,121.11,112,29417,120.72
706,91,31387,121.13,134,29551,120.75
707,83,31470,121.15,121,29672,120.78
708,82,31552,121.16,110,29782,120.8
709,102,31654,121.19,106,29888,120.82
710,83,31737,121.2,112,30000,120.84
711,87,31824,121.22,121,30121,120.87
712,87,31911,121.24,102,30223,120.89
713,36,31947,121.25,139,30362,120.92
714,38,31985,121.25,119,30481,120.94
715,33,32018,121.26,113,30594,120.97
716,32,32050,121.27,129,30723,120.99
717,29,32079,121.27,114,30837,121.02
718,25,32104,121.28,124,30961,121.04
719,28,32132,121.28,122,31083,121.07
720,24,32156,121.29,104,31187,121.09
721,22,32178,121.29,110,31297,121.11
722,24,32202,121.3,102,31399,121.13
723,22,32224,121.3,116,31515,121.16
724,17,32241,121.31,89,31604,121.18
725,22,32263,121.31,42,31646,121.18
726,21,32284,121.32,36,31682,121.19
727,26,32310,121.32,24,31706,121.2
728,24,32334,121.33,28,31734,121.2
729,25,32359,121.33,22,31756,121.21
730,25,32384,121.34,34,31790,121.21
731,30,32414,121.34,36,31826,121.22
732,24,32438,121.35,25,31851,121.23
733,20,32458,121.35,24,31875,121.23
734,24,32482,121.36,36,31911,121.24
735,13,32495,121.36,29,31940,121.24
736,27,32522,121.36,23,31963,121.25
737,28,32550,121.37,28,31991,121.26
738,29,32579,121.38,18,32009,121.26
739,94,32673,121.4,22,32031,121.26
740,98,32771,121.42,23,32054,121.27
741,67,32838,121.43,21,32075,121.27
742,98,32936,121.45,19,32094,121.28
743,90,33026,121.47,19,32113,121.28
744,109,33135,121.49,26,32139,121.29
745,113,33248,121.52,21,32160,121.29
746,104,33352,121.54,27,32187,121.3
747,119,33471,121.56,23,32210,121.3
748,119,33590,121.59,23,32233,121.31
749,110,33700,121.61,18,32251,121.31
750,103,33803,121.63,15,32266,121.31
751,108,33911,121.65,19,32285,121.32
752,101,34012,121.67,19,32304,121.32
753,76,34088,121.69,21,32325,121.32
754,74,34162,121.7,26,32351,121.33
755,77,34239,121.72,18,32369,121.33
756,65,34304,121.73,23,32392,121.34
757,37,34341,121.74,26,32418,121.34
758,33,34374,121.75,21,32439,121.35
759,56,34430,121.76,24,32463,121.35
760,28,34458,121.77,19,32482,121.36
761,40,34498,121.77,22,32504,121.36
762,41,34539,121.78,25,32529,121.37
763,26,34565,121.79,19,32548,121.37
764,29,34594,121.79,14,32562,121.37
765,38,34632,121.8,16,32578,121.38
766,43,34675,121.81,23,32601,121.38
767,36,34711,121.82,19,32620,121.39
768,52,34763,121.83,18,32638,121.39
769,28,34791,121.83,19,32657,121.39
770,28,34819,121.84,21,32678,121.4
771,30,34849,121.85,19,32697,121.4
772,67,34916,121.86,20,32717,121.41
773,88,35004,121.88,15,32732,121.41
774,107,35111,121.9,19,32751,121.41
775,112,35223,121.92,17,32768,121.42
776,106,35329,121.95,18,32786,121.42
777,113,35442,121.97,19,32805,121.42
778,120,35562,121.99,17,32822,121.43
779,113,35675,122.02,14,32836,121.43
780,105,35780,122.04,16,32852,121.43
781,112,35892,122.06,15,32867,121.44
782,105,35997,122.08,18,32885,121.44
783,97,36094,122.1,15,32900,121.44
784,94,36188,122.12,16,32916,121.45
785,81,36269,122.14,16,32932,121.45
786,75,36344,122.16,15,32947,121.45
787,80,36424,122.17,16,32963,121.46
788,86,36510,122.19,13,32976,121.46
789,82,36592,122.21,15,32991,121.46
790,72,36664,122.22,14,33005,121.46
791,87,36751,122.24,14,33019,121.47
792,68,36819,122.25,15,33034,121.47
793,76,36895,122.27,15,33049,121.47
794,85,36980,122.29,14,33063,121.48
795,86,37066,122.31,12,33075,121.48
796,88,37154,122.32,13,33088,121.48
797,23,37177,122.33,15,33103,121.49
798,81,37258,122.34,13,33116,121.49
799,76,37334,122.36,13,33129,121.49
800,89,37423,122.38,13,33142,121.49
801,82,37505,122.4,13,33155,121.5
802,76,37581,122.41,13,33168,121.5
803,80,37661,122.43,12,33180,121.5
804,87,37748,122.45,12,33192,121.5
805,85,37833,122.46,12,33204,121.51
806,30,37863,122.47,14,33218,121.51
807,72,37935,122.48,12,33230,121.51
808,93,38028,122.5,11,33241,121.51
809,87,38115,122.52,10,33251,121.52
810,88,38203,122.54,10,33261,121.52
811,84,38287,122.56,10,33271,121.52
812,94,38381,122.58,11,33282,121.52
813,91,38472,122.6,11,33293,121.52
814,97,38569,122.62,10,33303,121.53
815,90,38659,122.63,9,33312,121.53
816,86,38745,122.65,10,33322,121.53
817,100,38845,122.67,10,33332,121.53
818,86,38931,122.69,9,33341,121.53
819,86,39017,122.71,12,33353,121.54
820,94,39111,122.73,10,33363,121.54
821,91,39202,122.75,11,33374,121.54
822,81,39283,122.76,8,33382,121.54
823,84,39367,122.78,9,33391,121.54
824,93,39460,122.8,11,33402,121.55
825,84,39544,122.82,11,33413,121.55
826,98,39642,122.84,10,33423,121.55
827,98,39740,122.86,9,33432,121.55
828,82,39822,122.88,9,33441,121.56
829,99,39921,122.9,8,33449,121.56
830,106,40027,122.92,10,33459,121.56
831,95,40122,122.94,9,33468,121.56
832,80,40202,122.95,10,33478,121.56
833,93,40295,122.97,11,33489,121.57
834,108,40403,123,10,33499,121.57
835,99,40502,123.02,10,33509,121.57
836,106,40608,123.04,12,33521,121.57
837,105,40713,123.06,8,33529,121.57
838,112,40825,123.08,9,33538,121.58
839,105,40930,123.1,9,33547,121.58
840,110,41040,123.13,9,33556,121.58
841,117,41157,123.15,10,33566,121.58
842,110,41267,123.17,11,33577,121.58
843,114,41381,123.2,12,33589,121.59
844,120,41501,123.22,9,33598,121.59
845,141,41642,123.25,12,33610,121.59
846,120,41762,123.28,10,33620,121.59
847,135,41897,123.3,11,33631,121.59
848,132,42029,123.33,9,33640,121.6
849,133,42162,123.36,14,33654,121.6
850,143,42305,123.39,11,33665,121.6
851,133,42438,123.42,9,33674,121.6
852,139,42577,123.45,11,33685,121.61
853,146,42723,123.48,10,33695,121.61
854,134,42857,123.5,10,33705,121.61
855,144,43001,123.53,10,33715,121.61
856,131,43132,123.56,12,33727,121.61
857,136,43268,123.59,8,33735,121.62
858,164,43432,123.62,9,33744,121.62
859,152,43584,123.65,10,33754,121.62
860,165,43749,123.69,10,33764,121.62
861,156,43905,123.72,13,33777,121.62
862,153,44058,123.75,10,33787,121.63
863,159,44217,123.78,10,33797,121.63
864,169,44386,123.82,10,33807,121.63
865,166,44552,123.85,10,33817,121.63
866,187,44739,123.89,11,33828,121.64
867,172,44911,123.93,11,33839,121.64
868,187,45098,123.97,9,33848,121.64
869,222,45320,124.01,10,33858,121.64
870,230,45550,124.06,10,33868,121.64
871,229,45779,124.11,11,33879,121.65
872,197,45976,124.15,9,33888,121.65
873,238,46214,124.2,9,33897,121.65
874,253,46467,124.25,10,33907,121.65
875,236,46703,124.3,10,33917,121.65
876,266,46969,124.35,10,33927,121.66
877,473,47442,124.45,12,33939,121.66
878,318,47760,124.52,10,33949,121.66
879,150,47910,124.55,12,33961,121.66
880,118,48028,124.57,9,33970,121.66
881,147,48175,124.6,11,33981,121.67
882,126,48301,124.63,11,33992,121.67
883,115,48416,124.65,11,34003,121.67
884,268,48684,124.71,12,34015,121.67
885,376,49060,124.79,13,34028,121.68
886,500,49560,124.89,11,34039,121.68
887,500,50060,124.99,12,34051,121.68
888,500,50560,125.1,10,34061,121.68
889,110,50670,125.12,9,34070,121.69
890,500,51170,125.22,10,34080,121.69
891,500,51670,125.33,11,34091,121.69
892,499,52169,125.43,11,34102,121.69
893,500,52669,125.53,9,34111,121.69
894,500,53169,125.64,10,34121,121.7
895,240,53409,125.69,11,34132,121.7
896,178,53587,125.72,9,34141,121.7
897,168,53755,125.76,9,34150,121.7
898,174,53929,125.79,12,34162,121.7
899,177,54106,125.83,10,34172,121.71
900,162,54268,125.86,10,34182,121.71
901,183,54451,125.9,9,34191,121.71
902,199,54650,125.94,10,34201,121.71
903,199,54849,125.98,9,34210,121.71
904,194,55043,126.02,11,34221,121.72
905,197,55240,126.06,10,34231,121.72
906,177,55417,126.1,11,34242,121.72
907,215,55632,126.15,11,34253,121.72
908,215,55847,126.19,11,34264,121.73
909,201,56048,126.23,11,34275,121.73
910,234,56282,126.28,11,34286,121.73
911,225,56507,126.33,11,34297,121.73
912,216,56723,126.37,14,34311,121.74
913,231,56954,126.42,10,34321,121.74
914,248,57202,126.47,12,34333,121.74
915,257,57459,126.52,11,34344,121.74
916,288,57747,126.58,10,34354,121.74
917,437,58184,126.67,11,34365,121.75
918,319,58503,126.74,9,34374,121.75
919,500,59003,126.84,10,34384,121.75
920,468,59471,126.94,12,34396,121.75
921,500,59971,127.04,16,34412,121.76
922,208,60179,127.09,11,34423,121.76
923,69,60248,127.1,9,34432,121.76
924,85,60333,127.12,11,34443,121.76
925,77,60410,127.13,11,34454,121.76
926,83,60493,127.15,10,34464,121.77
927,56,60549,127.16,12,34476,121.77
928,72,60621,127.18,13,34489,121.77
929,83,60704,127.2,16,34505,121.78
930,128,60832,127.22,15,34520,121.78
931,500,61332,127.33,15,34535,121.78
932,386,61718,127.41,12,34547,121.78
933,306,62024,127.47,16,34563,121.79
934,282,62306,127.53,11,34574,121.79
935,471,62777,127.62,14,34588,121.79
936,273,63050,127.68,18,34606,121.8
937,261,63311,127.73,16,34622,121.8
938,313,63624,127.8,19,34641,121.8
939,329,63953,127.87,18,34659,121.81
940,258,64211,127.92,19,34678,121.81
941,277,64488,127.98,22,34700,121.82
942,334,64822,128.05,14,34714,121.82
943,327,65149,128.11,24,34738,121.82
944,359,65508,128.19,24,34762,121.83
945,449,65957,128.28,31,34793,121.83
946,401,66358,128.37,32,34825,121.84
947,277,66635,128.42,57,34882,121.85
948,460,67095,128.52,139,35021,121.88
949,482,67577,128.62,64,35085,121.9
950,425,68002,128.71,34,35119,121.9
951,500,68502,128.81,24,35143,121.91
952,215,68717,128.85,19,35162,121.91
953,500,69217,128.96,17,35179,121.91
954,315,69532,129.02,20,35199,121.92
955,395,69927,129.1,15,35214,121.92
956,297,70224,129.16,17,35231,121.93
957,300,70524,129.23,22,35253,121.93
958,364,70888,129.3,18,35271,121.93
959,301,71189,129.36,18,35289,121.94
960,326,71515,129.43,12,35301,121.94
961,297,71812,129.49,15,35316,121.94
962,500,72312,129.6,14,35330,121.95
963,500,72812,129.7,15,35345,121.95
964,358,73170,129.77,14,35359,121.95
965,414,73584,129.86,12,35371,121.95
966,500,74084,129.96,17,35388,121.96
967,500,74584,130.07,16,35404,121.96
968,301,74885,130.13,14,35418,121.96
969,315,75200,130.19,10,35428,121.97
970,406,75606,130.28,13,35441,121.97
971,379,75985,130.36,16,35457,121.97
972,495,76480,130.46,15,35472,121.98
973,450,76930,130.55,11,35483,121.98
974,500,77430,130.66,14,35497,121.98
975,358,77788,130.73,10,35507,121.98
976,327,78115,130.8,11,35518,121.98
977,325,78440,130.86,11,35529,121.99
978,322,78762,130.93,13,35542,121.99
979,412,79174,131.02,11,35553,121.99
980,383,79557,131.1,15,35568,122
981,335,79892,131.16,13,35581,122
982,292,80184,131.23,16,35597,122
983,407,80591,131.31,20,35617,122.01
984,500,81091,131.41,20,35637,122.01
985,457,81548,131.51,20,35657,122.01
986,449,81997,131.6,18,35675,122.02
987,417,82414,131.69,20,35695,122.02
988,235,82649,131.74,19,35714,122.03
989,285,82934,131.79,17,35731,122.03
990,500,83434,131.9,17,35748,122.03
991,333,83767,131.97,18,35766,122.04
992,307,84074,132.03,19,35785,122.04
993,413,84487,132.12,20,35805,122.04
994,164,84651,132.15,20,35825,122.05
995,9,84660,132.15,28,35853,122.05
996,9,84669,132.15,25,35878,122.06
997,9,84678,132.16,36,35914,122.07
998,11,84689,132.16,25,35939,122.07
999,9,84698,132.16,27,35966,122.08
1000,10,84708,132.16,31,35997,122.08
1001,10,84718,132.16,23,36020,122.09
1002,10,84728,132.17,26,36046,122.09
1003,9,84737,132.17,37,36083,122.1
1004,10,84747,132.17,67,36150,122.12
1005,248,84995,132.22,52,36202,122.13
1006,10,85005,132.22,71,36273,122.14
1007,10,85015,132.22,84,36357,122.16
1008,10,85025,132.23,207,36564,122.2
1009,9,85034,132.23,362,36926,122.28
1010,10,85044,132.23,321,37247,122.34
1011,10,85054,132.23,212,37459,122.39
1012,9,85063,132.23,129,37588,122.41
1013,12,85075,132.24,213,37801,122.46
1014,9,85084,132.24,279,38080,122.51
1015,9,85093,132.24,251,38331,122.57
1016,10,85103,132.24,187,38518,122.61
1017,10,85113,132.25,406,38924,122.69
1018,10,85123,132.25,218,39142,122.73
1019,9,85132,132.25,500,39642,122.84
1020,10,85142,132.25,500,40142,122.94
1021,9,85151,132.25,500,40642,123.04
1022,8,85159,132.25,500,41142,123.15
1023,10,85169,132.26,500,41642,123.25
1024,10,85179,132.26,500,42142,123.36
1025,9,85188,132.26,500,42642,123.46
1026,10,85198,132.26,500,43142,123.56
1027,11,85209,132.26,500,43642,123.67
1028,11,85220,132.27,500,44142,123.77
1029,9,85229,132.27,500,44642,123.87
1030,9,85238,132.27,500,45142,123.98
1031,10,85248,132.27,493,45635,124.08
1032,12,85260,132.28,500,46135,124.18
1033,14,85274,132.28,500,46635,124.28
1034,10,85284,132.28,500,47135,124.39
1035,10,85294,132.28,500,47635,124.49
1036,12,85306,132.28,500,48135,124.6
1037,9,85315,132.29,500,48635,124.7
1038,14,85329,132.29,490,49125,124.8
1039,11,85340,132.29,500,49625,124.9
1040,13,85353,132.29,434,50059,124.99
1041,13,85366,132.3,392,50451,125.07
1042,15,85381,132.3,411,50862,125.16
1043,240,85621,132.35,463,51325,125.25
1044,404,86025,132.43,386,51711,125.33
1045,171,86196,132.47,393,52104,125.42
1046,13,86209,132.47,418,52522,125.5
1047,12,86221,132.47,443,52965,125.59
1048,12,86233,132.48,404,53369,125.68
1049,12,86245,132.48,399,53768,125.76
1050,12,86257,132.48,395,54163,125.84
1051,11,86268,132.48,344,54507,125.91
1052,13,86281,132.49,364,54871,125.99
1053,9,86290,132.49,378,55249,126.07
1054,12,86302,132.49,266,55515,126.12
1055,12,86314,132.49,300,55815,126.18
1056,8,86322,132.5,257,56072,126.24
1057,11,86333,132.5,282,56354,126.3
1058,9,86342,132.5,290,56644,126.36
1059,8,86350,132.5,275,56919,126.41
1060,10,86360,132.5,290,57209,126.47
1061,10,86370,132.51,284,57493,126.53
1062,9,86379,132.51,296,57789,126.59
1063,10,86389,132.51,316,58105,126.66
1064,11,86400,132.51,345,58450,126.73
1065,9,86409,132.51,252,58702,126.78
1066,8,86417,132.51,273,58975,126.84
1067,11,86428,132.52,262,59237,126.89
1068,10,86438,132.52,230,59467,126.94
1069,10,86448,132.52,241,59708,126.99
1070,9,86457,132.52,250,59958,127.04
1071,10,86467,132.53,244,60202,127.09
1072,11,86478,132.53,245,60447,127.14
1073,8,86486,132.53,238,60685,127.19
1074,9,86495,132.53,251,60936,127.24
1075,9,86504,132.53,242,61178,127.29
1076,11,86515,132.54,199,61377,127.33
1077,9,86524,132.54,201,61578,127.38
1078,9,86533,132.54,109,61687,127.4
1079,9,86542,132.54,180,61867,127.44
1080,13,86555,132.54,169,62036,127.47
1081,12,86567,132.55,107,62143,127.49
1082,10,86577,132.55,171,62314,127.53
1083,10,86587,132.55,157,62471,127.56
1084,10,86597,132.55,123,62594,127.59
1085,14,86611,132.55,114,62708,127.61
1086,9,86620,132.56,123,62831,127.64
1087,10,86630,132.56,121,62952,127.66
1088,11,86641,132.56,115,63067,127.68
1089,11,86652,132.56,118,63185,127.71
1090,12,86664,132.57,121,63306,127.73
1091,11,86675,132.57,108,63414,127.76
1092,12,86687,132.57,103,63517,127.78
1093,12,86699,132.57,124,63641,127.8
1094,14,86713,132.58,156,63797,127.84
1095,183,86896,132.61,125,63922,127.86
1096,438,87334,132.7,131,64053,127.89
1097,192,87526,132.74,118,64171,127.91
1098,178,87704,132.78,95,64266,127.93
1099,170,87874,132.82,117,64383,127.96
1100,173,88047,132.85,116,64499,127.98
1101,176,88223,132.89,99,64598,128
1102,198,88421,132.93,97,64695,128.02
1103,218,88639,132.97,114,64809,128.04
1104,232,88871,133.02,99,64908,128.07
1105,256,89127,133.08,109,65017,128.09
1106,244,89371,133.13,98,65115,128.11
1107,249,89620,133.18,101,65216,128.13
1108,239,89859,133.23,111,65327,128.15
1109,221,90080,133.27,101,65428,128.17
1110,241,90321,133.32,100,65528,128.19
1111,227,90548,133.37,114,65642,128.22
1112,225,90773,133.42,101,65743,128.24
1113,209,90982,133.46,119,65862,128.26
1114,202,91184,133.5,105,65967,128.28
1115,228,91412,133.55,106,66073,128.31
1116,199,91611,133.59,117,66190,128.33
1117,233,91844,133.64,123,66313,128.36
1118,216,92060,133.68,127,66440,128.38
1119,232,92292,133.73,110,66550,128.4
1120,224,92516,133.78,99,66649,128.43
1121,208,92724,133.82,99,66748,128.45
1122,207,92931,133.86,26,66774,128.45
1123,245,93176,133.91,92,66866,128.47
1124,242,93418,133.96,21,66887,128.47
1125,229,93647,134.01,21,66908,128.48
1126,254,93901,134.06,20,66928,128.48
1127,233,94134,134.11,17,66945,128.49
1128,218,94352,134.16,18,66963,128.49
1129,237,94589,134.21,17,66980,128.49
1130,254,94843,134.26,16,66996,128.5
1131,277,95120,134.32,12,67008,128.5
1132,291,95411,134.38,13,67021,128.5
1133,311,95722,134.44,11,67032,128.5
1134,297,96019,134.5,11,67043,128.51
1135,332,96351,134.57,10,67053,128.51
1136,367,96718,134.65,10,67063,128.51
1137,401,97119,134.73,12,67075,128.51
1138,499,97618,134.83,10,67085,128.52
1139,500,98118,134.94,11,67096,128.52
1140,500,98618,135.04,12,67108,128.52
1141,500,99118,135.14,10,67118,128.52
1142,485,99603,135.24,11,67129,128.52
1143,500,100103,135.35,9,67138,128.53
1144,500,100603,135.45,12,67150,128.53
1145,500,101103,135.55,10,67160,128.53
1146,500,101603,135.66,13,67173,128.53
1147,464,102067,135.75,12,67185,128.54
1148,408,102475,135.84,9,67194,128.54
1149,355,102830,135.91,13,67207,128.54
1150,317,103147,135.98,10,67217,128.54
1151,278,103425,136.03,11,67228,128.55
1152,268,103693,136.09,10,67238,128.55
1153,301,103994,136.15,10,67248,128.55
1154,269,104263,136.21,10,67258,128.55
1155,278,104541,136.26,11,67269,128.55
1156,262,104803,136.32,11,67280,128.56
1157,302,105105,136.38,10,67290,128.56
1158,298,105403,136.44,9,67299,128.56
1159,291,105694,136.5,10,67309,128.56
1160,301,105995,136.57,10,67319,128.56
1161,387,106382,136.65,11,67330,128.57
1162,339,106721,136.72,11,67341,128.57
1163,361,107082,136.79,11,67352,128.57
1164,403,107485,136.87,9,67361,128.57
1165,420,107905,136.96,10,67371,128.57
1166,500,108405,137.06,8,67379,128.58
1167,342,108747,137.13,11,67390,128.58
1168,358,109105,137.21,11,67401,128.58
1169,383,109488,137.29,9,67410,128.58
1170,500,109988,137.39,9,67419,128.58
1171,500,110488,137.49,11,67430,128.59
1172,500,110988,137.6,10,67440,128.59
1173,314,111302,137.66,11,67451,128.59
1174,318,111620,137.73,8,67459,128.59
1175,366,111986,137.8,9,67468,128.59
1176,360,112346,137.88,11,67479,128.6
1177,500,112846,137.98,11,67490,128.6
1178,418,113264,138.07,11,67501,128.6
1179,367,113631,138.14,9,67510,128.6
1180,500,114131,138.25,9,67519,128.61
1181,500,114631,138.35,9,67528,128.61
1182,339,114970,138.42,10,67538,128.61
1183,376,115346,138.5,9,67547,128.61
1184,500,115846,138.6,10,67557,128.61
1185,500,116346,138.71,11,67568,128.62
1186,500,116846,138.81,9,67577,128.62
1187,355,117201,138.88,9,67586,128.62
1188,370,117571,138.96,11,67597,128.62
1189,500,118071,139.06,11,67608,128.62
1190,500,118571,139.17,8,67616,128.63
1191,290,118861,139.23,10,67626,128.63
1192,189,119050,139.27,8,67634,128.63
1193,11,119061,139.27,10,67644,128.63
1194,11,119072,139.27,10,67654,128.63
1195,11,119083,139.27,12,67666,128.64
1196,9,119092,139.27,10,67676,128.64
1197,10,119102,139.28,9,67685,128.64
1198,10,119112,139.28,10,67695,128.64
1199,9,119121,139.28,10,67705,128.64
1200,11,119132,139.28,10,67715,128.65
1201,10,119142,139.29,9,67724,128.65
1202,12,119154,139.29,11,67735,128.65
1203,12,119166,139.29,9,67744,128.65
1204,468,119634,139.39,9,67753,128.65
1205,9,119643,139.39,10,67763,128.66
1206,9,119652,139.39,9,67772,128.66
1207,11,119663,139.39,9,67781,128.66
1208,9,119672,139.39,9,67790,128.66
1209,10,119682,139.4,11,67801,128.66
1210,9,119691,139.4,13,67814,128.67
1211,10,119701,139.4,12,67826,128.67
1212,10,119711,139.4,10,67836,128.67
1213,9,119720,139.4,11,67847,128.67
1214,9,119729,139.41,8,67855,128.67
1215,10,119739,139.41,10,67865,128.68
1216,10,119749,139.41,10,67875,128.68
1217,10,119759,139.41,10,67885,128.68
1218,8,119767,139.41,9,67894,128.68
1219,10,119777,139.42,11,67905,128.69
1220,8,119785,139.42,8,67913,128.69
1221,9,119794,139.42,10,67923,128.69
1222,10,119804,139.42,8,67931,128.69
1223,10,119814,139.42,10,67941,128.69
1224,8,119822,139.43,10,67951,128.69
1225,10,119832,139.43,9,67960,128.7
1226,10,119842,139.43,10,67970,128.7
1227,13,119855,139.43,12,67982,128.7
1228,11,119866,139.43,9,67991,128.7
1229,10,119876,139.44,9,68000,128.7
1230,9,119885,139.44,10,68010,128.71
1231,11,119896,139.44,10,68020,128.71
1232,10,119906,139.44,9,68029,128.71
1233,11,119917,139.45,9,68038,128.71
1234,12,119929,139.45,8,68046,128.71
1235,12,119941,139.45,11,68057,128.72
1236,11,119952,139.45,9,68066,128.72
1237,11,119963,139.45,10,68076,128.72
1238,14,119977,139.46,10,68086,128.72
1239,10,119987,139.46,9,68095,128.72
1240,12,119999,139.46,9,68104,128.73
1241,13,120012,139.47,9,68113,128.73
1242,14,120026,139.47,9,68122,128.73
1243,13,120039,139.47,9,68131,128.73
1244,13,120052,139.47,9,68140,128.73
1245,17,120069,139.48,9,68149,128.74
1246,161,120230,139.51,9,68158,128.74
1247,403,120633,139.59,10,68168,128.74
1248,135,120768,139.62,9,68177,128.74
1249,14,120782,139.62,11,68188,128.74
1250,12,120794,139.63,10,68198,128.75
1251,13,120807,139.63,9,68207,128.75
1252,12,120819,139.63,11,68218,128.75
1253,15,120834,139.64,11,68229,128.75
1254,15,120849,139.64,9,68238,128.75
1255,13,120862,139.64,8,68246,128.76
1256,13,120875,139.64,10,68256,128.76
1257,12,120887,139.65,10,68266,128.76
1258,12,120899,139.65,8,68274,128.76
1259,12,120911,139.65,11,68285,128.76
1260,10,120921,139.65,10,68295,128.77
1261,11,120932,139.66,11,68306,128.77
1262,10,120942,139.66,9,68315,128.77
1263,11,120953,139.66,9,68324,128.77
1264,11,120964,139.66,10,68334,128.77
1265,11,120975,139.66,10,68344,128.78
1266,12,120987,139.67,9,68353,128.78
1267,12,120999,139.67,9,68362,128.78
1268,12,121011,139.67,9,68371,128.78
1269,12,121023,139.67,12,68383,128.78
1270,12,121035,139.68,11,68394,128.79
1271,11,121046,139.68,9,68403,128.79
1272,10,121056,139.68,10,68413,128.79
1273,13,121069,139.68,9,68422,128.79
1274,13,121082,139.69,11,68433,128.79
1275,12,121094,139.69,9,68442,128.8
1276,13,121107,139.69,9,68451,128.8
1277,14,121121,139.69,10,68461,128.8
1278,141,121262,139.72,9,68470,128.8
1279,226,121488,139.77,10,68480,128.8
1280,500,121988,139.87,9,68489,128.81
1281,500,122488,139.98,12,68501,128.81
1282,500,122988,140.08,10,68511,128.81
1283,500,123488,140.18,10,68521,128.81
1284,500,123988,140.29,11,68532,128.81
1285,500,124488,140.39,10,68542,128.82
1286,500,124988,140.49,10,68552,128.82
1287,500,125488,140.6,8,68560,128.82
1288,500,125988,140.7,10,68570,128.82
1289,500,126488,140.8,9,68579,128.82
1290,500,126988,140.91,10,68589,128.83
1291,500,127488,141.01,10,68599,128.83
1292,500,127988,141.12,11,68610,128.83
1293,500,128488,141.22,10,68620,128.83
1294,500,128988,141.32,13,68633,128.84
1295,500,129488,141.43,11,68644,128.84
1296,500,129988,141.53,11,68655,128.84
1297,500,130488,141.63,10,68665,128.84
1298,500,130988,141.74,11,68676,128.84
1299,500,131488,141.84,10,68686,128.85
1300,500,131988,141.94,9,68695,128.85
,,,,9,68704,128.85
,,,,10,68714,128.85
,,,,10,68724,128.85
,,,,12,68736,128.86
,,,,12,68748,128.86
,,,,14,68762,128.86
,,,,12,68774,128.86
,,,,12,68786,128.87
,,,,11,68797,128.87
,,,,12,68809,128.87
,,,,12,68821,128.87
,,,,11,68832,128.88
,,,,10,68842,128.88
,,,,10,68852,128.88
,,,,11,68863,128.88
,,,,14,68877,128.89
,,,,13,68890,128.89
,,,,13,68903,128.89
,,,,12,68915,128.89
,,,,10,68925,128.9
,,,,14,68939,128.9
,,,,11,68950,128.9
,,,,12,68962,128.9
,,,,11,68973,128.91
,,,,14,68987,128.91
,,,,13,69000,128.91
,,,,16,69016,128.91
,,,,20,69036,128.92
,,,,20,69056,128.92
,,,,78,69134,128.94
,,,,273,69407,129
,,,,10,69417,129
,,,,9,69426,129
,,,,9,69435,129
,,,,9,69444,129
,,,,9,69453,129.01
,,,,9,69462,129.01
,,,,10,69472,129.01
,,,,10,69482,129.01
,,,,12,69494,129.01
,,,,8,69502,129.02
,,,,9,69511,129.02
,,,,9,69520,129.02
,,,,10,69530,129.02
,,,,11,69541,129.02
,,,,10,69551,129.03
,,,,12,69563,129.03
,,,,10,69573,129.03
,,,,10,69583,129.03
,,,,9,69592,129.03
,,,,10,69602,129.04
,,,,12,69614,129.04
,,,,14,69628,129.04
,,,,67,69695,129.06
,,,,11,69706,129.06
,,,,11,69717,129.06
,,,,11,69728,129.06
,,,,11,69739,129.06
,,,,11,69750,129.07
,,,,9,69759,129.07
,,,,9,69768,129.07
,,,,10,69778,129.07
,,,,12,69790,129.08
,,,,9,69799,129.08
,,,,11,69810,129.08
,,,,10,69820,129.08
,,,,9,69829,129.08
,,,,9,69838,129.08
,,,,10,69848,129.09
,,,,10,69858,129.09
,,,,9,69867,129.09
,,,,9,69876,129.09
,,,,10,69886,129.09
,,,,8,69894,129.1
,,,,9,69903,129.1
,,,,11,69914,129.1
,,,,9,69923,129.1
,,,,9,69932,129.1
,,,,10,69942,129.11
,,,,8,69950,129.11
,,,,9,69959,129.11
,,,,10,69969,129.11
,,,,11,69980,129.11
,,,,10,69990,129.12
,,,,10,70000,129.12
,,,,10,70010,129.12
,,,,9,70019,129.12
,,,,10,70029,129.12
,,,,10,70039,129.13
,,,,11,70050,129.13
,,,,12,70062,129.13
,,,,11,70073,129.13
,,,,13,70086,129.14
,,,,11,70097,129.14
,,,,11,70108,129.14
,,,,9,70117,129.14
,,,,10,70127,129.14
,,,,11,70138,129.15
,,,,11,70149,129.15
,,,,11,70160,129.15
,,,,74,70234,129.17
,,,,79,70313,129.18
,,,,94,70407,129.2
,,,,96,70503,129.22
,,,,135,70638,129.25
,,,,198,70836,129.29
,,,,340,71176,129.36
,,,,326,71502,129.43
,,,,157,71659,129.46
,,,,138,71797,129.49
,,,,141,71938,129.52
,,,,132,72070,129.55
,,,,148,72218,129.58
,,,,176,72394,129.61
,,,,145,72539,129.64
,,,,140,72679,129.67
,,,,147,72826,129.7
,,,,154,72980,129.73
,,,,162,73142,129.77
,,,,138,73280,129.8
,,,,147,73427,129.83
,,,,163,73590,129.86
,,,,185,73775,129.9
,,,,148,73923,129.93
,,,,131,74054,129.96
,,,,149,74203,129.99
,,,,158,74361,130.02
,,,,125,74486,130.05
,,,,140,74626,130.08
,,,,134,74760,130.1
,,,,151,74911,130.13
,,,,132,75043,130.16
,,,,136,75179,130.19
,,,,129,75308,130.22
,,,,141,75449,130.25
,,,,155,75604,130.28
,,,,132,75736,130.31
,,,,162,75898,130.34
,,,,150,76048,130.37
,,,,129,76177,130.4
,,,,188,76365,130.44
,,,,131,76496,130.46
,,,,147,76643,130.49
,,,,159,76802,130.53
,,,,136,76938,130.55
,,,,147,77085,130.58
,,,,130,77215,130.61
,,,,173,77388,130.65
,,,,174,77562,130.68
,,,,187,77749,130.72
,,,,171,77920,130.76
,,,,149,78069,130.79
,,,,151,78220,130.82
,,,,147,78367,130.85
,,,,177,78544,130.89
,,,,164,78708,130.92
,,,,157,78865,130.95
,,,,163,79028,130.99
,,,,177,79205,131.02
,,,,157,79362,131.06
,,,,163,79525,131.09
,,,,168,79693,131.12
,,,,174,79867,131.16
,,,,151,80018,131.19
,,,,157,80175,131.22
,,,,162,80337,131.26
,,,,153,80490,131.29
,,,,140,80630,131.32
,,,,191,80821,131.36
,,,,158,80979,131.39
,,,,148,81127,131.42
,,,,137,81264,131.45
,,,,147,81411,131.48
,,,,214,81625,131.52
,,,,139,81764,131.55
,,,,160,81924,131.59
,,,,424,82348,131.67
,,,,500,82848,131.78
,,,,156,83004,131.81
,,,,313,83317,131.87
,,,,227,83544,131.92
,,,,279,83823,131.98
,,,,167,83990,132.01
,,,,500,84490,132.12
,,,,268,84758,132.17
,,,,255,85013,132.22
,,,,148,85161,132.26
,,,,155,85316,132.29
,,,,159,85475,132.32
,,,,170,85645,132.36
,,,,160,85805,132.39
,,,,158,85963,132.42
,,,,199,86162,132.46
,,,,199,86361,132.5
,,,,194,86555,132.54
,,,,235,86790,132.59
,,,,443,87233,132.68
,,,,500,87733,132.79
,,,,197,87930,132.83
,,,,275,88205,132.88
,,,,162,88367,132.92
,,,,500,88867,133.02
,,,,241,89108,133.07
,,,,291,89399,133.13
,,,,364,89763,133.21
,,,,500,90263,133.31
,,,,500,90763,133.41
,,,,405,91168,133.5
,,,,208,91376,133.54
,,,,183,91559,133.58
,,,,141,91700,133.61
,,,,297,91997,133.67
,,,,500,92497,133.77
,,,,146,92643,133.8
,,,,154,92797,133.83
,,,,134,92931,133.86
,,,,365,93296,133.94
,,,,279,93575,134
,,,,158,93733,134.03
,,,,500,94233,134.13
,,,,124,94357,134.16
,,,,139,94496,134.19
,,,,205,94701,134.23
,,,,113,94814,134.25
,,,,128,94942,134.28
,,,,229,95171,134.33
,,,,180,95351,134.36
,,,,190,95541,134.4
,,,,143,95684,134.43
,,,,331,96015,134.5
,,,,261,96276,134.55
,,,,278,96554,134.61
,,,,257,96811,134.67
,,,,237,97048,134.71
,,,,231,97279,134.76
,,,,185,97464,134.8
,,,,350,97814,134.87
,,,,266,98080,134.93
,,,,404,98484,135.01
,,,,500,98984,135.11
,,,,403,99387,135.2
,,,,500,99887,135.3
,,,,500,100387,135.4
,,,,500,100887,135.51
,,,,483,101370,135.61
,,,,500,101870,135.71
,,,,223,102093,135.76
,,,,338,102431,135.83
,,,,361,102792,135.9
,,,,221,103013,135.95
,,,,270,103283,136
,,,,231,103514,136.05
,,,,246,103760,136.1
,,,,252,104012,136.15
,,,,444,104456,136.25
,,,,265,104721,136.3
,,,,203,104924,136.34
,,,,149,105073,136.37
,,,,168,105241,136.41
,,,,145,105386,136.44
,,,,186,105572,136.48
,,,,348,105920,136.55
,,,,197,106117,136.59
,,,,197,106314,136.63
,,,,173,106487,136.67
,,,,240,106727,136.72
,,,,150,106877,136.75
,,,,163,107040,136.78
,,,,444,107484,136.87
,,,,128,107612,136.9
,,,,140,107752,136.93
,,,,117,107869,136.95
,,,,128,107997,136.98
,,,,125,108122,137.01
,,,,139,108261,137.03
,,,,103,108364,137.06
,,,,115,108479,137.08
,,,,71,108550,137.09
,,,,77,108627,137.11
,,,,63,108690,137.12
,,,,85,108775,137.14
,,,,79,108854,137.16
,,,,76,108930,137.17
,,,,79,109009,137.19
,,,,77,109086,137.2
,,,,48,109134,137.21
,,,,63,109197,137.23
,,,,54,109251,137.24
,,,,65,109316,137.25
,,,,62,109378,137.27
,,,,44,109422,137.27
,,,,55,109477,137.29
,,,,52,109529,137.3
,,,,56,109585,137.31
,,,,67,109652,137.32
,,,,63,109715,137.33
,,,,53,109768,137.35
,,,,49,109817,137.36
,,,,38,109855,137.36
,,,,37,109892,137.37
,,,,38,109930,137.38
,,,,52,109982,137.39
,,,,74,110056,137.41
,,,,82,110138,137.42
,,,,74,110212,137.44
,,,,64,110276,137.45
,,,,74,110350,137.47
,,,,73,110423,137.48
,,,,92,110515,137.5
,,,,68,110583,137.51
,,,,82,110665,137.53
,,,,52,110717,137.54
,,,,99,110816,137.56
,,,,65,110881,137.58
,,,,79,110960,137.59
,,,,88,111048,137.61
,,,,106,111154,137.63
,,,,214,111368,137.68
,,,,89,111457,137.7
,,,,131,111588,137.72
,,,,500,112088,137.83
,,,,269,112357,137.88
,,,,103,112460,137.9
,,,,108,112568,137.92
,,,,283,112851,137.98
,,,,198,113049,138.02
,,,,102,113151,138.05
,,,,106,113257,138.07
,,,,442,113699,138.16
,,,,170,113869,138.19
,,,,117,113986,138.22
,,,,500,114486,138.32
,,,,178,114664,138.36
,,,,469,115133,138.46
,,,,500,115633,138.56
,,,,284,115917,138.62
,,,,191,116108,138.66
,,,,364,116472,138.73
,,,,423,116895,138.82
,,,,411,117306,138.91
,,,,258,117564,138.96
,,,,226,117790,139.01
,,,,380,118170,139.08
,,,,489,118659,139.19
,,,,174,118833,139.22
,,,,242,119075,139.27
,,,,187,119262,139.31
,,,,293,119555,139.37
,,,,364,119919,139.45
,,,,335,120254,139.52
,,,,248,120502,139.57
,,,,214,120716,139.61
,,,,500,121216,139.71
,,,,479,121695,139.81
,,,,500,122195,139.92
,,,,249,122444,139.97
,,,,500,122944,140.07
,,,,282,123226,140.13
,,,,500,123726,140.23
,,,,215,123941,140.28
,,,,461,124402,140.37
,,,,493,124895,140.48
,,,,429,125324,140.56
,,,,257,125581,140.62
,,,,412,125993,140.7
,,,,485,126478,140.8
,,,,500,126978,140.91
,,,,500,127478,141.01
,,,,424,127902,141.1
,,,,352,128254,141.17
,,,,220,128474,141.22
,,,,258,128732,141.27
,,,,207,128939,141.31
,,,,184,129123,141.35
,,,,176,129299,141.39
,,,,171,129470,141.42
,,,,143,129613,141.45
,,,,111,129724,141.47
,,,,85,129809,141.49
,,,,95,129904,141.51
,,,,93,129997,141.53
,,,,88,130085,141.55
,,,,99,130184,141.57
,,,,96,130280,141.59
,,,,107,130387,141.61
,,,,155,130542,141.64
,,,,157,130699,141.68
,,,,142,130841,141.71
,,,,257,131098,141.76
,,,,169,131267,141.79
,,,,232,131499,141.84
,,,,172,131671,141.88
,,,,167,131838,141.91
,,,,163,132001,141.95
,,,,137,132138,141.97
,,,,137,132275,142
,,,,156,132431,142.03
,,,,124,132555,142.06
,,,,126,132681,142.09
,,,,149,132830,142.12
,,,,174,133004,142.15
,,,,113,133117,142.18
,,,,153,133270,142.21
,,,,112,133382,142.23
,,,,253,133635,142.28
,,,,354,133989,142.36
,,,,243,134232,142.41
,,,,347,134579,142.48
,,,,229,134808,142.53
,,,,309,135117,142.59
,,,,295,135412,142.65
,,,,356,135768,142.72
,,,,176,135944,142.76
,,,,165,136109,142.8
,,,,279,136388,142.85
,,,,223,136611,142.9
,,,,271,136882,142.96
,,,,179,137061,142.99
,,,,226,137287,143.04
,,,,219,137506,143.08
,,,,366,137872,143.16
,,,,248,138120,143.21
,,,,221,138341,143.26
,,,,301,138642,143.32
,,,,232,138874,143.37
,,,,152,139026,143.4
,,,,146,139172,143.43
,,,,142,139314,143.46
,,,,153,139467,143.49
,,,,127,139594,143.52
,,,,118,139712,143.54
,,,,131,139843,143.57
,,,,130,139973,143.59
,,,,114,140087,143.62
,,,,107,140194,143.64
,,,,111,140305,143.66
,,,,101,140406,143.68
,,,,114,140520,143.71
,,,,125,140645,143.73
,,,,114,140759,143.76
,,,,114,140873,143.78
,,,,122,140995,143.81
,,,,114,141109,143.83
,,,,110,141219,143.85
,,,,114,141333,143.88
,,,,121,141454,143.9
,,,,112,141566,143.92
,,,,108,141674,143.95
,,,,109,141783,143.97
,,,,129,141912,144
,,,,121,142033,144.02
,,,,120,142153,144.05
,,,,117,142270,144.07
,,,,144,142414,144.1
,,,,121,142535,144.12
,,,,126,142661,144.15
,,,,150,142811,144.18
,,,,138,142949,144.21
,,,,159,143108,144.24
,,,,171,143279,144.28
,,,,170,143449,144.31
,,,,261,143710,144.37
,,,,500,144210,144.47
,,,,365,144575,144.55
,,,,234,144809,144.6
,,,,378,145187,144.67
,,,,295,145482,144.73
,,,,300,145782,144.8
,,,,500,146282,144.9
,,,,500,146782,145
,,,,423,147205,145.09
,,,,410,147615,145.18
,,,,483,148098,145.28
,,,,500,148598,145.38
,,,,298,148896,145.44
,,,,295,149191,145.5
,,,,255,149446,145.55
,,,,365,149811,145.63
,,,,293,150104,145.69
,,,,330,150434,145.76
,,,,500,150934,145.86
,,,,495,151429,145.96
,,,,296,151725,146.03
,,,,404,152129,146.11
,,,,388,152517,146.19
,,,,295,152812,146.25
,,,,299,153111,146.31
,,,,272,153383,146.37
,,,,247,153630,146.42
,,,,208,153838,146.46
,,,,178,154016,146.5
,,,,194,154210,146.54
,,,,159,154369,146.57
,,,,155,154524,146.6
,,,,142,154666,146.63
,,,,136,154802,146.66
,,,,131,154933,146.69
,,,,116,155049,146.71
,,,,100,155149,146.73
,,,,90,155239,146.75
,,,,89,155328,146.77
,,,,104,155432,146.79
,,,,119,155551,146.82
,,,,124,155675,146.84
,,,,124,155799,146.87
,,,,131,155930,146.9
,,,,109,156039,146.92
,,,,111,156150,146.94
,,,,125,156275,146.97
,,,,137,156412,147
,,,,124,156536,147.02
,,,,108,156644,147.04
,,,,117,156761,147.07
,,,,116,156877,147.09
,,,,128,157005,147.12
,,,,104,157109,147.14
,,,,106,157215,147.16
,,,,108,157323,147.18
,,,,114,157437,147.21
,,,,104,157541,147.23
,,,,121,157662,147.25
,,,,122,157784,147.28
,,,,118,157902,147.3
,,,,107,158009,147.33
,,,,114,158123,147.35
,,,,105,158228,147.37
,,,,104,158332,147.39
,,,,107,158439,147.41
,,,,108,158547,147.44
,,,,106,158653,147.46
,,,,104,158757,147.48
,,,,108,158865,147.5
,,,,15,158880,147.51
,,,,16,158896,147.51
,,,,95,158991,147.53
,,,,98,159089,147.55
,,,,98,159187,147.57
,,,,15,159202,147.57
,,,,16,159218,147.58
,,,,18,159236,147.58
,,,,12,159248,147.58
,,,,12,159260,147.58
,,,,10,159270,147.59
,,,,10,159280,147.59
,,,,11,159291,147.59
,,,,10,159301,147.59
,,,,11,159312,147.6
,,,,10,159322,147.6
,,,,8,159330,147.6
,,,,10,159340,147.6
,,,,10,159350,147.6
,,,,10,159360,147.61
,,,,10,159370,147.61
,,,,12,159382,147.61
,,,,9,159391,147.61
,,,,10,159401,147.61
,,,,10,159411,147.62
,,,,10,159421,147.62
,,,,9,159430,147.62
,,,,10,159440,147.62
,,,,9,159449,147.62
,,,,10,159459,147.63
,,,,9,159468,147.63
,,,,8,159476,147.63
,,,,9,159485,147.63
,,,,10,159495,147.63
,,,,8,159503,147.63
,,,,9,159512,147.64
,,,,10,159522,147.64
,,,,10,159532,147.64
,,,,10,159542,147.64
,,,,9,159551,147.64
,,,,9,159560,147.65
,,,,10,159570,147.65
,,,,10,159580,147.65
,,,,10,159590,147.65
,,,,10,159600,147.66
,,,,11,159611,147.66
,,,,10,159621,147.66
,,,,10,159631,147.66
,,,,8,159639,147.66
,,,,9,159648,147.66
,,,,9,159657,147.67
,,,,12,159669,147.67
,,,,10,159679,147.67
,,,,9,159688,147.67
,,,,10,159698,147.68
,,,,9,159707,147.68
,,,,10,159717,147.68
,,,,9,159726,147.68
,,,,9,159735,147.68
,,,,11,159746,147.69
,,,,9,159755,147.69
,,,,12,159767,147.69
,,,,8,159775,147.69
,,,,9,159784,147.69
,,,,9,159793,147.69
,,,,9,159802,147.7
,,,,10,159812,147.7
,,,,10,159822,147.7
,,,,10,159832,147.7
,,,,10,159842,147.71
,,,,11,159853,147.71
,,,,9,159862,147.71
,,,,9,159871,147.71
,,,,9,159880,147.71
,,,,10,159890,147.72
,,,,10,159900,147.72
,,,,10,159910,147.72
,,,,9,159919,147.72
,,,,10,159929,147.72
,,,,9,159938,147.72
,,,,10,159948,147.73
,,,,9,159957,147.73
,,,,8,159965,147.73
,,,,10,159975,147.73
,,,,8,159983,147.73
,,,,9,159992,147.74
,,,,8,160000,147.74
,,,,10,160010,147.74
,,,,8,160018,147.74
,,,,10,160028,147.74
,,,,9,160037,147.75
,,,,11,160048,147.75
,,,,9,160057,147.75
,,,,9,160066,147.75
,,,,10,160076,147.75
,,,,9,160085,147.76
,,,,8,160093,147.76
,,,,11,160104,147.76
,,,,10,160114,147.76
,,,,9,160123,147.76
,,,,11,160134,147.77
,,,,10,160144,147.77
,,,,10,160154,147.77
,,,,10,160164,147.77
,,,,9,160173,147.77
,,,,12,160185,147.78
,,,,8,160193,147.78
,,,,10,160203,147.78
,,,,9,160212,147.78
,,,,9,160221,147.78
,,,,8,160229,147.79
,,,,10,160239,147.79
,,,,10,160249,147.79
,,,,10,160259,147.79
,,,,13,160272,147.79
,,,,9,160281,147.8
,,,,10,160291,147.8
,,,,8,160299,147.8
,,,,10,160309,147.8
,,,,10,160319,147.8
,,,,9,160328,147.81
,,,,9,160337,147.81
,,,,11,160348,147.81
,,,,9,160357,147.81
,,,,9,160366,147.81
,,,,10,160376,147.82
,,,,10,160386,147.82
,,,,11,160397,147.82
,,,,11,160408,147.82
,,,,10,160418,147.82
,,,,9,160427,147.83
,,,,11,160438,147.83
,,,,9,160447,147.83
,,,,10,160457,147.83
,,,,11,160468,147.83
,,,,9,160477,147.84
,,,,8,160485,147.84
,,,,8,160493,147.84
,,,,9,160502,147.84
,,,,8,160510,147.84
,,,,9,160519,147.85
,,,,10,160529,147.85
,,,,9,160538,147.85
,,,,13,160551,147.85
,,,,14,160565,147.85
,,,,18,160583,147.86
,,,,20,160603,147.86
,,,,141,160744,147.89
,,,,372,161116,147.97
,,,,11,161127,147.97
,,,,10,161137,147.97
,,,,10,161147,147.98
,,,,11,161158,147.98
,,,,11,161169,147.98
,,,,11,161180,147.98
,,,,11,161191,147.98
,,,,10,161201,147.99
,,,,9,161210,147.99
,,,,10,161220,147.99
,,,,10,161230,147.99
,,,,9,161239,147.99
,,,,8,161247,148
,,,,10,161257,148
,,,,10,161267,148
,,,,10,161277,148
,,,,9,161286,148
,,,,10,161296,148.01
,,,,10,161306,148.01
,,,,10,161316,148.01
,,,,10,161326,148.01
,,,,9,161335,148.01
,,,,10,161345,148.02
,,,,9,161354,148.02
,,,,10,161364,148.02
,,,,10,161374,148.02
,,,,9,161383,148.02
,,,,9,161392,148.03
,,,,9,161401,148.03
,,,,8,161409,148.03
,,,,8,161417,148.03
,,,,9,161426,148.03
,,,,10,161436,148.03
,,,,9,161445,148.04
,,,,10,161455,148.04
,,,,9,161464,148.04
,,,,9,161473,148.04
,,,,10,161483,148.04
,,,,13,161496,148.05
,,,,11,161507,148.05
,,,,10,161517,148.05
,,,,9,161526,148.05
,,,,10,161536,148.06
,,,,9,161545,148.06
,,,,9,161554,148.06
,,,,9,161563,148.06
,,,,8,161571,148.06
,,,,8,161579,148.06
,,,,10,161589,148.07
,,,,10,161599,148.07
,,,,8,161607,148.07
,,,,11,161618,148.07
,,,,11,161629,148.07
,,,,9,161638,148.08
,,,,10,161648,148.08
,,,,10,161658,148.08
,,,,12,161670,148.08
,,,,9,161679,148.09
,,,,11,161690,148.09
,,,,11,161701,148.09
,,,,10,161711,148.09
,,,,11,161722,148.09
,,,,11,161733,148.1
,,,,11,161744,148.1
,,,,10,161754,148.1
,,,,10,161764,148.1
,,,,10,161774,148.1
,,,,10,161784,148.11
,,,,9,161793,148.11
,,,,10,161803,148.11
,,,,10,161813,148.11
,,,,11,161824,148.12
,,,,11,161835,148.12
,,,,15,161850,148.12
,,,,14,161864,148.12
,,,,16,161880,148.13
,,,,16,161896,148.13
,,,,19,161915,148.13
,,,,15,161930,148.14
,,,,12,161942,148.14
,,,,17,161959,148.14
,,,,16,161975,148.15
,,,,17,161992,148.15
,,,,16,162008,148.15
,,,,16,162024,148.16
,,,,12,162036,148.16
,,,,15,162051,148.16
,,,,13,162064,148.16
,,,,17,162081,148.17
,,,,16,162097,148.17
,,,,13,162110,148.17
,,,,17,162127,148.18
,,,,16,162143,148.18
,,,,20,162163,148.19
,,,,81,162244,148.2
,,,,86,162330,148.22
,,,,82,162412,148.24
,,,,94,162506,148.26
,,,,139,162645,148.28
,,,,131,162776,148.31
,,,,184,162960,148.35
,,,,117,163077,148.37
,,,,120,163197,148.4
,,,,134,163331,148.43
,,,,133,163464,148.45
,,,,130,163594,148.48
,,,,114,163708,148.5
,,,,151,163859,148.54
,,,,174,164033,148.57
,,,,216,164249,148.62
,,,,363,164612,148.69
,,,,141,164753,148.72
,,,,125,164878,148.75
,,,,125,165003,148.77
,,,,123,165126,148.8
,,,,161,165287,148.83
,,,,181,165468,148.87
,,,,159,165627,148.9
,,,,129,165756,148.93
,,,,130,165886,148.96
,,,,153,166039,148.99
,,,,130,166169,149.01
,,,,191,166360,149.05
,,,,180,166540,149.09
,,,,159,166699,149.12
,,,,177,166876,149.16
,,,,170,167046,149.2
,,,,148,167194,149.23
,,,,137,167331,149.25
,,,,115,167446,149.28
,,,,142,167588,149.31
,,,,220,167808,149.35
,,,,150,167958,149.38
,,,,137,168095,149.41
,,,,127,168222,149.44
,,,,221,168443,149.48
,,,,117,168560,149.51
,,,,158,168718,149.54
,,,,245,168963,149.59
,,,,117,169080,149.62
,,,,200,169280,149.66
,,,,160,169440,149.69
,,,,136,169576,149.72
,,,,130,169706,149.75
,,,,428,170134,149.83
,,,,119,170253,149.86
,,,,160,170413,149.89
,,,,174,170587,149.93
,,,,225,170812,149.97
,,,,136,170948,150
,,,,135,171083,150.03
,,,,192,171275,150.07
,,,,203,171478,150.11
,,,,181,171659,150.15
,,,,452,172111,150.24
,,,,254,172365,150.3
,,,,218,172583,150.34
,,,,117,172700,150.37
,,,,146,172846,150.4
,,,,215,173061,150.44
,,,,208,173269,150.48
,,,,176,173445,150.52
,,,,147,173592,150.55
,,,,141,173733,150.58
,,,,306,174039,150.64
,,,,135,174174,150.67
,,,,211,174385,150.71
,,,,203,174588,150.76
,,,,123,174711,150.78
,,,,142,174853,150.81
,,,,172,175025,150.85
,,,,146,175171,150.88
,,,,197,175368,150.92
,,,,149,175517,150.95
,,,,125,175642,150.97
,,,,123,175765,151
,,,,260,176025,151.05
,,,,170,176195,151.09
,,,,361,176556,151.16
,,,,250,176806,151.21
,,,,137,176943,151.24
,,,,189,177132,151.28
,,,,247,177379,151.33
,,,,166,177545,151.37
,,,,136,177681,151.4
,,,,179,177860,151.43
,,,,168,178028,151.47
,,,,170,178198,151.5
,,,,152,178350,151.53
,,,,210,178560,151.58
,,,,163,178723,151.61
,,,,317,179040,151.68
,,,,149,179189,151.71
,,,,416,179605,151.79
,,,,500,180105,151.9
,,,,168,180273,151.93
,,,,338,180611,152
,,,,181,180792,152.04
,,,,139,180931,152.07
,,,,260,181191,152.12
,,,,314,181505,152.19
,,,,410,181915,152.27
,,,,154,182069,152.3
,,,,158,182227,152.34
,,,,140,182367,152.37
,,,,199,182566,152.41
,,,,179,182745,152.44
,,,,224,182969,152.49
,,,,500,183469,152.59
,,,,185,183654,152.63
,,,,135,183789,152.66
,,,,323,184112,152.73
,,,,171,184283,152.76
,,,,285,184568,152.82
,,,,393,184961,152.9
,,,,176,185137,152.94
,,,,372,185509,153.02
,,,,173,185682,153.05
,,,,266,185948,153.11
,,,,191,186139,153.15
,,,,399,186538,153.23
,,,,141,186679,153.26
,,,,347,187026,153.33
,,,,226,187252,153.38
,,,,500,187752,153.48
,,,,209,187961,153.52
,,,,207,188168,153.57
,,,,500,188668,153.67
,,,,112,188780,153.69
,,,,154,188934,153.72
,,,,147,189081,153.75
,,,,161,189242,153.79
,,,,165,189407,153.82
,,,,347,189754,153.89
,,,,500,190254,154
,,,,271,190525,154.05
,,,,491,191016,154.15
,,,,257,191273,154.21
,,,,403,191676,154.29
,,,,245,191921,154.34
,,,,500,192421,154.45
,,,,275,192696,154.5
,,,,466,193162,154.6
,,,,251,193413,154.65
,,,,238,193651,154.7
,,,,168,193819,154.73
,,,,175,193994,154.77
,,,,144,194138,154.8
,,,,152,194290,154.83
,,,,138,194428,154.86
,,,,149,194577,154.89
,,,,124,194701,154.92
,,,,132,194833,154.94
,,,,142,194975,154.97
,,,,135,195110,155
,,,,127,195237,155.03
,,,,142,195379,155.06
,,,,137,195516,155.09
,,,,138,195654,155.11
,,,,129,195783,155.14
,,,,142,195925,155.17
,,,,116,196041,155.19
,,,,136,196177,155.22
,,,,127,196304,155.25
,,,,148,196452,155.28
,,,,140,196592,155.31
,,,,135,196727,155.34
,,,,133,196860,155.36
,,,,150,197010,155.39
,,,,122,197132,155.42
,,,,132,197264,155.45
,,,,129,197393,155.47
,,,,114,197507,155.5
,,,,127,197634,155.52
,,,,124,197758,155.55
,,,,118,197876,155.57
,,,,130,198006,155.6
,,,,123,198129,155.63
,,,,130,198259,155.65
,,,,131,198390,155.68
,,,,114,198504,155.7
,,,,133,198637,155.73
,,,,122,198759,155.76
,,,,120,198879,155.78
,,,,126,199005,155.81
,,,,118,199123,155.83
,,,,115,199238,155.86
,,,,112,199350,155.88
,,,,121,199471,155.9
,,,,110,199581,155.93
,,,,106,199687,155.95
,,,,112,199799,155.97
,,,,106,199905,155.99
,,,,105,200010,156.02
,,,,119,200129,156.04
,,,,108,200237,156.06
,,,,119,200356,156.09
,,,,114,200470,156.11
,,,,113,200583,156.13
,,,,114,200697,156.16
,,,,119,200816,156.18
,,,,130,200946,156.21
,,,,110,201056,156.23
,,,,116,201172,156.26
,,,,134,201306,156.28
,,,,112,201418,156.31
,,,,132,201550,156.33
,,,,127,201677,156.36
,,,,126,201803,156.39
,,,,129,201932,156.41
,,,,164,202096,156.45
,,,,143,202239,156.48
,,,,138,202377,156.5
,,,,161,202538,156.54
,,,,154,202692,156.57
,,,,137,202829,156.6
,,,,142,202971,156.63
,,,,136,203107,156.66
,,,,124,203231,156.68
,,,,122,203353,156.71
,,,,111,203464,156.73
,,,,132,203596,156.76
,,,,109,203705,156.78
,,,,112,203817,156.8
,,,,106,203923,156.82
,,,,112,204035,156.85
,,,,104,204139,156.87
,,,,96,204235,156.89
,,,,97,204332,156.91
,,,,108,204440,156.93
,,,,92,204532,156.95
,,,,112,204644,156.97
,,,,101,204745,156.99
,,,,113,204858,157.02
,,,,103,204961,157.04
,,,,110,205071,157.06
,,,,99,205170,157.08
,,,,99,205269,157.1
,,,,108,205377,157.13
,,,,106,205483,157.15
,,,,107,205590,157.17
,,,,95,205685,157.19
,,,,105,205790,157.21
,,,,103,205893,157.23
,,,,104,205997,157.25
,,,,104,206101,157.28
,,,,94,206195,157.29
,,,,100,206295,157.32
,,,,107,206402,157.34
,,,,100,206502,157.36
,,,,100,206602,157.38
,,,,104,206706,157.4
,,,,97,206803,157.42
,,,,92,206895,157.44
,,,,96,206991,157.46
,,,,103,207094,157.48
,,,,93,207187,157.5
,,,,93,207280,157.52
,,,,90,207370,157.54
,,,,97,207467,157.56
,,,,98,207565,157.58
,,,,95,207660,157.6
,,,,93,207753,157.62
,,,,40,207793,157.63
,,,,97,207890,157.65
,,,,27,207917,157.65
,,,,24,207941,157.66
,,,,24,207965,157.66
,,,,21,207986,157.67
,,,,23,208009,157.67
,,,,20,208029,157.67
,,,,17,208046,157.68
,,,,16,208062,157.68
,,,,13,208075,157.68
,,,,13,208088,157.69
,,,,17,208105,157.69
,,,,16,208121,157.69
,,,,14,208135,157.7
,,,,14,208149,157.7
,,,,12,208161,157.7
,,,,12,208173,157.7
,,,,12,208185,157.71
,,,,13,208198,157.71
,,,,16,208214,157.71
,,,,19,208233,157.72
,,,,19,208252,157.72
,,,,22,208274,157.72
,,,,17,208291,157.73
,,,,16,208307,157.73
,,,,16,208323,157.73
,,,,16,208339,157.74
,,,,15,208354,157.74
,,,,11,208365,157.74
,,,,14,208379,157.75
,,,,16,208395,157.75
,,,,14,208409,157.75
,,,,14,208423,157.76
,,,,14,208437,157.76
,,,,18,208455,157.76
,,,,15,208470,157.77
,,,,17,208487,157.77
,,,,13,208500,157.77
,,,,14,208514,157.77
,,,,13,208527,157.78
,,,,11,208538,157.78
,,,,14,208552,157.78
,,,,16,208568,157.79
,,,,13,208581,157.79
,,,,15,208596,157.79
,,,,15,208611,157.79
,,,,14,208625,157.8
,,,,15,208640,157.8
,,,,14,208654,157.8
,,,,15,208669,157.81
,,,,13,208682,157.81
,,,,14,208696,157.81
,,,,10,208706,157.81
,,,,13,208719,157.82
,,,,14,208733,157.82
,,,,13,208746,157.82
,,,,13,208759,157.83
,,,,15,208774,157.83
,,,,14,208788,157.83
,,,,15,208803,157.83
,,,,13,208816,157.84
,,,,13,208829,157.84
,,,,13,208842,157.84
,,,,13,208855,157.84
,,,,13,208868,157.85
,,,,10,208878,157.85
,,,,10,208888,157.85
,,,,13,208901,157.85
,,,,12,208913,157.86
,,,,11,208924,157.86
,,,,11,208935,157.86
,,,,9,208944,157.86
,,,,10,208954,157.87
,,,,10,208964,157.87
,,,,11,208975,157.87
,,,,12,208987,157.87
,,,,11,208998,157.87
,,,,10,209008,157.88
,,,,10,209018,157.88
,,,,11,209029,157.88
,,,,11,209040,157.88
,,,,12,209052,157.89
,,,,11,209063,157.89
,,,,10,209073,157.89
,,,,11,209084,157.89
,,,,12,209096,157.89
,,,,10,209106,157.9
,,,,12,209118,157.9
,,,,12,209130,157.9
,,,,10,209140,157.9
,,,,9,209149,157.91
,,,,9,209158,157.91
,,,,12,209170,157.91
,,,,10,209180,157.91
,,,,11,209191,157.91
,,,,11,209202,157.92
,,,,10,209212,157.92
,,,,9,209221,157.92
,,,,10,209231,157.92
,,,,10,209241,157.92
,,,,10,209251,157.93
,,,,10,209261,157.93
,,,,10,209271,157.93
,,,,9,209280,157.93
,,,,10,209290,157.93
,,,,9,209299,157.94
,,,,10,209309,157.94
,,,,12,209321,157.94
,,,,11,209332,157.94
,,,,12,209344,157.95
,,,,10,209354,157.95
,,,,11,209365,157.95
,,,,11,209376,157.95
,,,,9,209385,157.95
,,,,11,209396,157.96
,,,,11,209407,157.96
,,,,12,209419,157.96
,,,,11,209430,157.96
,,,,11,209441,157.97
,,,,11,209452,157.97
,,,,9,209461,157.97
,,,,9,209470,157.97
,,,,10,209480,157.97
,,,,11,209491,157.98
,,,,10,209501,157.98
,,,,11,209512,157.98
,,,,10,209522,157.98
,,,,9,209531,157.98
,,,,9,209540,157.99
,,,,9,209549,157.99
,,,,11,209560,157.99
,,,,9,209569,157.99
,,,,11,209580,157.99
,,,,11,209591,158
,,,,12,209603,158
,,,,9,209612,158
,,,,10,209622,158
,,,,11,209633,158.01
,,,,9,209642,158.01
,,,,10,209652,158.01
,,,,12,209664,158.01
,,,,12,209676,158.01
,,,,11,209687,158.02
,,,,10,209697,158.02
,,,,10,209707,158.02
,,,,9,209716,158.02
,,,,9,209725,158.02
,,,,9,209734,158.03
,,,,9,209743,158.03
,,,,9,209752,158.03
,,,,10,209762,158.03
,,,,11,209773,158.03
,,,,10,209783,158.04
,,,,11,209794,158.04
,,,,9,209803,158.04
,,,,11,209814,158.04
,,,,12,209826,158.05
,,,,11,209837,158.05
,,,,10,209847,158.05
,,,,11,209858,158.05
,,,,12,209870,158.05
,,,,11,209881,158.06
,,,,10,209891,158.06
,,,,13,209904,158.06
,,,,12,209916,158.06
,,,,12,209928,158.07
,,,,12,209940,158.07
,,,,11,209951,158.07
,,,,10,209961,158.07
,,,,13,209974,158.08
,,,,11,209985,158.08
,,,,11,209996,158.08
,,,,11,210007,158.08
,,,,10,210017,158.09
,,,,11,210028,158.09
,,,,13,210041,158.09
,,,,11,210052,158.09
,,,,13,210065,158.1
,,,,13,210078,158.1
,,,,10,210088,158.1
,,,,14,210102,158.1
,,,,13,210115,158.11
,,,,11,210126,158.11
,,,,11,210137,158.11
,,,,13,210150,158.11
,,,,15,210165,158.12
,,,,15,210180,158.12
,,,,16,210196,158.12
,,,,18,210214,158.13
,,,,12,210226,158.13
,,,,16,210242,158.13
,,,,13,210255,158.13
,,,,16,210271,158.14
,,,,15,210286,158.14
,,,,16,210302,158.14
,,,,15,210317,158.15
,,,,14,210331,158.15
,,,,14,210345,158.15
,,,,14,210359,158.16
,,,,18,210377,158.16
,,,,18,210395,158.16
,,,,17,210412,158.17
,,,,17,210429,158.17
,,,,16,210445,158.17
,,,,15,210460,158.18
,,,,20,210480,158.18
,,,,20,210500,158.19
,,,,23,210523,158.19
,,,,20,210543,158.19
,,,,19,210562,158.2
,,,,18,210580,158.2
,,,,24,210604,158.21
,,,,20,210624,158.21
,,,,25,210649,158.22
,,,,27,210676,158.22
,,,,29,210705,158.23
,,,,94,210799,158.25
,,,,108,210907,158.27
,,,,136,211043,158.3
,,,,500,211543,158.4
,,,,127,211670,158.43
,,,,103,211773,158.45
,,,,103,211876,158.47
,,,,100,211976,158.49
,,,,109,212085,158.51
,,,,101,212186,158.53
,,,,104,212290,158.56
,,,,104,212394,158.58
,,,,101,212495,158.6
,,,,103,212598,158.62
,,,,109,212707,158.64
,,,,114,212821,158.67
,,,,108,212929,158.69
,,,,108,213037,158.71
,,,,100,213137,158.73
,,,,97,213234,158.75
,,,,108,213342,158.77
,,,,103,213445,158.79
,,,,109,213554,158.82
,,,,105,213659,158.84
,,,,110,213769,158.86
,,,,98,213867,158.88
,,,,99,213966,158.9
,,,,114,214080,158.93
,,,,103,214183,158.95
,,,,101,214284,158.97
,,,,106,214390,158.99
,,,,110,214500,159.01
,,,,114,214614,159.04
,,,,104,214718,159.06
,,,,109,214827,159.08
,,,,117,214944,159.1
,,,,107,215051,159.13
,,,,118,215169,159.15
,,,,96,215265,159.17
,,,,100,215365,159.19
,,,,105,215470,159.21
,,,,94,215564,159.23
,,,,100,215664,159.25
,,,,98,215762,159.27
,,,,58,215820,159.29
,,,,61,215881,159.3
,,,,68,215949,159.31
,,,,52,216001,159.32
,,,,59,216060,159.34
,,,,47,216107,159.35
,,,,44,216151,159.35
,,,,47,216198,159.36
,,,,55,216253,159.38
,,,,59,216312,159.39
,,,,63,216375,159.4
,,,,38,216413,159.41
,,,,54,216467,159.42
,,,,50,216517,159.43
,,,,50,216567,159.44
,,,,56,216623,159.45
,,,,44,216667,159.46
,,,,43,216710,159.47
,,,,33,216743,159.48
,,,,40,216783,159.49
,,,,52,216835,159.5
,,,,42,216877,159.5
,,,,50,216927,159.51
,,,,30,216957,159.52
,,,,42,216999,159.53
,,,,57,217056,159.54
,,,,48,217104,159.55
,,,,50,217154,159.56
,,,,65,217219,159.58
,,,,56,217275,159.59
,,,,45,217320,159.6
,,,,65,217385,159.61
,,,,46,217431,159.62
,,,,55,217486,159.63
,,,,52,217538,159.64
,,,,67,217605,159.66
,,,,58,217663,159.67
,,,,63,217726,159.68
,,,,72,217798,159.7
,,,,83,217881,159.71
,,,,153,218034,159.74
,,,,125,218159,159.77
,,,,160,218319,159.8
,,,,223,218542,159.85
,,,,154,218696,159.88
,,,,208,218904,159.92
,,,,199,219103,159.97
,,,,500,219603,160.07
,,,,500,220103,160.17
,,,,266,220369,160.23
,,,,285,220654,160.29
,,,,311,220965,160.35
,,,,326,221291,160.42
,,,,309,221600,160.48
,,,,332,221932,160.55
,,,,324,222256,160.62
,,,,382,222638,160.7
,,,,421,223059,160.78
,,,,393,223452,160.86
,,,,405,223857,160.95
,,,,383,224240,161.03
,,,,381,224621,161.11
,,,,354,224975,161.18
,,,,373,225348,161.26
,,,,370,225718,161.33
,,,,372,226090,161.41
,,,,373,226463,161.49
,,,,374,226837,161.57
,,,,395,227232,161.65
,,,,314,227546,161.71
,,,,263,227809,161.77
,,,,232,228041,161.81
,,,,220,228261,161.86
,,,,189,228450,161.9
,,,,177,228627,161.94
,,,,179,228806,161.97
,,,,168,228974,162.01
,,,,145,229119,162.04
,,,,148,229267,162.07
,,,,146,229413,162.1
,,,,142,229555,162.13
,,,,142,229697,162.16
,,,,123,229820,162.18
,,,,153,229973,162.21
,,,,157,230130,162.25
,,,,134,230264,162.27
,,,,174,230438,162.31
,,,,163,230601,162.34
,,,,141,230742,162.37
,,,,144,230886,162.4
,,,,123,231009,162.43
,,,,151,231160,162.46
,,,,146,231306,162.49
,,,,116,231422,162.51
,,,,145,231567,162.54
,,,,140,231707,162.57
,,,,140,231847,162.6
,,,,157,232004,162.63
,,,,160,232164,162.67
,,,,170,232334,162.7
,,,,172,232506,162.74
,,,,173,232679,162.77
,,,,206,232885,162.82
,,,,237,233122,162.87
,,,,216,233338,162.91
,,,,222,233560,162.96
,,,,244,233804,163.01
,,,,244,234048,163.06
,,,,257,234305,163.11
,,,,356,234661,163.18
,,,,265,234926,163.24
,,,,280,235206,163.3
,,,,309,235515,163.36
,,,,241,235756,163.41
,,,,284,236040,163.47
,,,,354,236394,163.54
,,,,272,236666,163.6
,,,,283,236949,163.66
,,,,368,237317,163.73
,,,,323,237640,163.8
,,,,310,237950,163.86
,,,,500,238450,163.97
,,,,307,238757,164.03
,,,,426,239183,164.12
,,,,295,239478,164.18
,,,,388,239866,164.26
,,,,500,240366,164.36
,,,,403,240769,164.45
,,,,341,241110,164.52
,,,,498,241608,164.62
,,,,500,242108,164.72
,,,,384,242492,164.8
,,,,500,242992,164.91
,,,,333,243325,164.98
,,,,476,243801,165.07
,,,,500,244301,165.18
,,,,394,244695,165.26
,,,,500,245195,165.36
,,,,500,245695,165.47
,,,,451,246146,165.56
,,,,367,246513,165.64
,,,,317,246830,165.7
,,,,404,247234,165.78
,,,,500,247734,165.89
,,,,390,248124,165.97
,,,,500,248624,166.07
,,,,362,248986,166.15
,,,,306,249292,166.21
,,,,324,249616,166.28
,,,,489,250105,166.38
,,,,500,250605,166.48
,,,,241,250846,166.53
,,,,393,251239,166.61
,,,,375,251614,166.69
,,,,236,251850,166.74
,,,,235,252085,166.79
,,,,309,252394,166.85
,,,,233,252627,166.9
,,,,210,252837,166.94
,,,,177,253014,166.98
,,,,196,253210,167.02
,,,,180,253390,167.06
,,,,164,253554,167.09
,,,,186,253740,167.13
,,,,199,253939,167.17
,,,,143,254082,167.2
,,,,175,254257,167.24
,,,,166,254423,167.27
,,,,206,254629,167.31
,,,,328,254957,167.38
,,,,172,255129,167.42
,,,,496,255625,167.52
,,,,297,255922,167.58
,,,,351,256273,167.65
,,,,289,256562,167.71
,,,,314,256876,167.78
,,,,435,257311,167.87
,,,,500,257811,167.97
,,,,500,258311,168.08
,,,,267,258578,168.13
,,,,263,258841,168.19
,,,,500,259341,168.29
,,,,487,259828,168.39
,,,,453,260281,168.48
,,,,500,260781,168.59
,,,,500,261281,168.69
,,,,500,261781,168.79
,,,,500,262281,168.9
,,,,500,262781,169
,,,,224,263005,169.05
,,,,214,263219,169.09
,,,,298,263517,169.15
,,,,318,263835,169.22
,,,,500,264335,169.32
,,,,465,264800,169.42
,,,,500,265300,169.52
,,,,500,265800,169.63
,,,,225,266025,169.67
,,,,430,266455,169.76
,,,,500,266955,169.86
,,,,500,267455,169.97
,,,,500,267955,170.07
,,,,267,268222,170.13
,,,,299,268521,170.19
,,,,466,268987,170.29
,,,,419,269406,170.37
,,,,500,269906,170.48
,,,,447,270353,170.57
,,,,231,270584,170.62
,,,,500,271084,170.72
,,,,268,271352,170.77
,,,,500,271852,170.88
,,,,396,272248,170.96
,,,,348,272596,171.03
,,,,144,272740,171.06
,,,,297,273037,171.12
,,,,500,273537,171.23
,,,,156,273693,171.26
,,,,500,274193,171.36
,,,,167,274360,171.4
,,,,141,274501,171.43
,,,,178,274679,171.46
,,,,175,274854,171.5
,,,,457,275311,171.59
,,,,218,275529,171.64
,,,,378,275907,171.72
,,,,432,276339,171.81
,,,,500,276839,171.91
,,,,344,277183,171.98
,,,,500,277683,172.08
,,,,155,277838,172.12
,,,,428,278266,172.2
,,,,500,278766,172.31
,,,,228,278994,172.36
,,,,500,279494,172.46
,,,,500,279994,172.56
,,,,475,280469,172.66
,,,,452,280921,172.75
,,,,500,281421,172.86
,,,,434,281855,172.95
,,,,432,282287,173.04
,,,,435,282722,173.13
,,,,418,283140,173.21
,,,,500,283640,173.32
,,,,500,284140,173.42
,,,,500,284640,173.52
,,,,500,285140,173.63
,,,,447,285587,173.72
,,,,405,285992,173.8
,,,,344,286336,173.87
,,,,376,286712,173.95
,,,,358,287070,174.03
,,,,319,287389,174.09
,,,,411,287800,174.18
,,,,439,288239,174.27
,,,,377,288616,174.35
,,,,101,288717,174.37
,,,,143,288860,174.4
,,,,356,289216,174.47
,,,,91,289307,174.49
,,,,118,289425,174.51
,,,,220,289645,174.56
,,,,350,289995,174.63
,,,,212,290207,174.68
,,,,312,290519,174.74
,,,,483,291002,174.84
,,,,337,291339,174.91
,,,,255,291594,174.96
,,,,283,291877,175.02
,,,,481,292358,175.12
,,,,336,292694,175.19
,,,,500,293194,175.29
,,,,500,293694,175.4
,,,,500,294194,175.5
,,,,417,294611,175.59
,,,,450,295061,175.68
,,,,500,295561,175.78
,,,,412,295973,175.87
,,,,500,296473,175.97
,,,,438,296911,176.06
,,,,500,297411,176.17
,,,,500,297911,176.27
,,,,500,298411,176.37
,,,,500,298911,176.48
,,,,500,299411,176.58
,,,,447,299858,176.67
,,,,417,300275,176.76
,,,,500,300775,176.86
,,,,500,301275,176.96
,,,,458,301733,177.06
,,,,418,302151,177.15
,,,,438,302589,177.24
,,,,500,303089,177.34
,,,,500,303589,177.44
,,,,500,304089,177.55
